yesrSe,sgSeCdName,sgCdName,guName,dongName,hlTotalFlowPop,hlTotalStayPop,hlTotalOffPop,hlWeekdayFlowCnt,hlWeekendFlowCnt,hlMenFlowCnt,hlWomenFlowCnt,hlMenStayCnt,hlWomenStayCnt,hlMenOffCnt,hlWomenOffCnt
2019년1분기,골목상권,부일로11길,구로구,수궁동,161694,14242,1723,110987,50715,87243,74446,7069,7173,935,788
2019년2분기,골목상권,부일로11길,구로구,수궁동,265306,14242,1736,178241,87052,132335,132964,7069,7173,1074,662
2019년1분기,골목상권,부일로15길,구로구,수궁동,190850,11001,1558,123714,67141,108281,82567,5438,5563,1058,500
2019년2분기,골목상권,부일로15길,구로구,수궁동,288272,11001,1369,184026,104237,155795,132476,5438,5563,834,535
2019년1분기,골목상권,부일로1길,구로구,수궁동,238761,8171,2231,157045,81719,118531,120230,4124,4047,1584,647
2019년2분기,골목상권,부일로1길,구로구,수궁동,308301,8171,2510,200784,107519,150331,157970,4124,4047,1740,770
2019년1분기,골목상권,남부순환로112길,금천구,가산동,1461213,17655,5498,1066622,394595,844363,616850,9575,8080,3316,2182
2019년2분기,골목상권,남부순환로112길,금천구,가산동,1717815,17655,4036,1241482,476330,979905,737907,9575,8080,2362,1674
2019년1분기,골목상권,독산로108길,금천구,독산3동,1871791,22020,5093,1386761,485040,1006595,865199,11088,10932,3346,1747
2019년2분기,골목상권,독산로108길,금천구,독산3동,1969484,22020,5283,1398704,570800,1030532,938962,11088,10932,3750,1533
2019년1분기,골목상권,독산로40길,금천구,시흥4동,581706,21044,1008,399326,182380,296836,284873,10436,10608,368,640
2019년2분기,골목상권,독산로40길,금천구,시흥4동,734653,21044,1565,494967,239684,350194,384461,10436,10608,961,604
2019년1분기,골목상권,독산로50길,금천구,시흥4동,218041,13364,499,147925,70115,110650,107396,6634,6730,164,335
2019년2분기,골목상권,독산로50길,금천구,시흥4동,297077,13364,977,196742,100333,130955,166130,6634,6730,610,367
2019년1분기,골목상권,독산로64길,금천구,독산2동,623439,18314,1453,436454,186986,323012,300430,9310,9004,523,930
2019년2분기,골목상권,독산로64길,금천구,독산2동,791671,18314,1616,539106,252571,394956,396719,9310,9004,909,707
2019년1분기,골목상권,독산로70길,금천구,독산4동,913530,20877,1657,636428,277094,487712,425821,10599,10278,672,985
2019년2분기,골목상권,독산로70길,금천구,독산4동,1089127,20877,1765,741180,347954,564187,524935,10599,10278,1104,661
2019년1분기,골목상권,새말로18길,구로구,구로5동,816584,18485,7253,564420,252163,417345,399236,8890,9595,3334,3919
2019년2분기,골목상권,새말로18길,구로구,구로5동,1012651,18485,10262,696051,316600,513216,499443,8890,9595,5194,5068
2019년1분기,골목상권,신도림로13길,구로구,신도림동,436433,12526,2789,315423,121002,240628,195797,6216,6310,1756,1033
2019년2분기,골목상권,신도림로13길,구로구,신도림동,559474,12526,4603,397534,161948,295185,264291,6216,6310,3433,1170
2019년1분기,골목상권,오류로8길,구로구,오류2동,1159379,18787,3182,800756,358625,585451,573937,9228,9559,1370,1812
2019년2분기,골목상권,오류로8길,구로구,오류2동,1363646,18787,3412,927061,436591,678661,684987,9228,9559,2181,1231
2019년1분기,골목상권,우마길,구로구,가리봉동,1157987,9776,8893,848160,309818,689875,468117,5077,4699,5338,3555
2019년2분기,골목상권,우마길,구로구,가리봉동,1411235,9776,5058,1019394,391847,832893,578344,5077,4699,3191,1867
2019년1분기,골목상권,금하로1길,금천구,독산1동,109019,4787,418,75394,33630,57325,51696,2373,2414,194,224
2019년2분기,골목상권,금하로1길,금천구,독산1동,133637,4787,1380,88058,45587,70542,63095,2373,2414,874,506
2019년1분기,골목상권,금하로24길,금천구,시흥5동,825501,16757,2422,578380,247133,420425,405075,8382,8375,1212,1210
2019년2분기,골목상권,금하로24길,금천구,시흥5동,975808,16757,1842,676200,299630,489978,485830,8382,8375,1050,792
2019년1분기,골목상권,시흥대로120길,금천구,독산4동,1305228,16559,4216,922306,382921,713116,592112,8425,8134,2269,1947
2019년2분기,골목상권,시흥대로120길,금천구,독산4동,1519971,16559,2877,1057868,462104,807816,712144,8425,8134,1943,934
2019년1분기,골목상권,시흥대로138길,금천구,독산3동,938094,11216,3589,679276,258828,521606,416491,5851,5365,1923,1666
2019년2분기,골목상권,시흥대로138길,금천구,독산3동,1132743,11216,1917,812253,320491,615419,517319,5851,5365,1165,752
2019년1분기,골목상권,시흥대로141길,금천구,독산1동,1175562,17909,5546,847566,328001,660676,514891,9629,8280,3244,2302
2019년2분기,골목상권,시흥대로141길,금천구,독산1동,1436296,17909,3100,1031469,404829,795667,640626,9629,8280,1893,1207
2019년1분기,골목상권,가마산로61길,영등포구,신길3동,1484329,14498,1670,1038363,445990,755465,728859,7307,7191,762,908
2019년2분기,골목상권,가마산로61길,영등포구,신길3동,1726298,14498,1074,1188742,537567,868451,857853,7307,7191,605,469
2019년1분기,골목상권,경인로77길,영등포구,문래동,909394,8223,24252,657400,252005,472330,437057,4077,4146,11856,12396
2019년2분기,골목상권,경인로77길,영등포구,문래동,1123920,8223,9616,805579,318343,573457,550461,4077,4146,5772,3844
2019년1분기,골목상권,경인로80길,영등포구,문래동,953940,7389,21754,683082,270868,503103,450831,3723,3666,10671,11083
2019년2분기,골목상권,경인로80길,영등포구,문래동,1206545,7389,8214,858712,347831,622951,583595,3723,3666,5256,2958
2019년1분기,골목상권,경인로90길,영등포구,문래동,1063463,7329,19805,732942,330519,500337,563121,3903,3426,9848,9957
2019년2분기,골목상권,경인로90길,영등포구,문래동,1271022,7329,8824,875677,395347,590347,680675,3903,3426,5515,3309
2019년1분기,골목상권,국회대로56길,영등포구,영등포동,1551053,13197,11445,1135380,415675,887482,663570,7377,5820,7706,3739
2019년2분기,골목상권,국회대로56길,영등포구,영등포동,1782055,13197,7396,1292073,489994,1011318,770729,7377,5820,4375,3021
2019년1분기,골목상권,당산로31길,영등포구,당산1동,1385753,10711,21931,1069652,316104,763481,622275,5352,5359,11386,10545
2019년2분기,골목상권,당산로31길,영등포구,당산1동,1656407,10711,16080,1270842,385559,885980,770426,5352,5359,9043,7037
2019년1분기,골목상권,시흥대로150길,금천구,독산3동,1324772,21007,3660,960297,364478,731026,593744,10785,10222,1914,1746
2019년2분기,골목상권,시흥대로150길,금천구,독산3동,1488382,21007,2651,1053808,434583,802359,686024,10785,10222,1573,1078
2019년1분기,골목상권,시흥대로153길,금천구,가산동,1215013,16893,3354,875443,339574,701438,513574,9235,7658,1752,1602
2019년2분기,골목상권,시흥대로153길,금천구,가산동,1432630,16893,3302,1023259,409374,820992,611633,9235,7658,1746,1556
2019년1분기,골목상권,시흥대로22길,금천구,시흥3동,192598,9054,8190,150539,42057,123169,69426,4560,4494,5143,3047
2019년2분기,골목상권,시흥대로22길,금천구,시흥3동,253096,9054,7864,198102,55005,155143,97949,4560,4494,4751,3113
2019년1분기,골목상권,시흥대로36길,금천구,시흥3동,192283,8938,7697,146168,46116,107043,85237,4443,4495,4550,3147
2019년2분기,골목상권,시흥대로36길,금천구,시흥3동,274839,8938,7357,209927,64929,148577,126259,4443,4495,4210,3147
2019년1분기,골목상권,시흥대로62가길,금천구,시흥1동,1510845,20422,3187,1049369,461477,779321,731520,10209,10213,948,2239
2019년2분기,골목상권,시흥대로62가길,금천구,시흥1동,1895789,20422,2092,1327223,568564,961542,934243,10209,10213,959,1133
2019년1분기,골목상권,시흥대로63길,금천구,시흥1동,1198849,12512,7583,848744,350114,612471,586379,6234,6278,3376,4207
2019년2분기,골목상권,시흥대로63길,금천구,시흥1동,1474631,12512,5201,1060022,414606,745409,729221,6234,6278,2592,2609
2019년1분기,골목상권,시흥대로68길,금천구,시흥1동,1678590,28061,5701,1178926,499664,864060,814533,14024,14037,2428,3273
2019년2분기,골목상권,시흥대로68길,금천구,시흥1동,2032940,28061,4174,1420341,612592,1024681,1008260,14024,14037,2360,1814
2019년1분기,골목상권,시흥대로84길,금천구,독산2동,920266,25023,2704,638343,281923,468859,451411,12625,12398,1039,1665
2019년2분기,골목상권,시흥대로84길,금천구,독산2동,1119398,25023,2535,759568,359813,552440,566963,12625,12398,1634,901
2019년1분기,골목상권,시흥대로94길,금천구,독산2동,1078655,21968,4127,754957,323706,588380,490284,11210,10758,2348,1779
2019년2분기,골목상권,시흥대로94길,금천구,독산2동,1290615,21968,3639,883679,406931,679741,610885,11210,10758,2395,1244
2019년1분기,골목상권,독산로78다길,금천구,독산4동,964214,19844,1200,665893,298307,519345,444863,9992,9852,445,755
2019년2분기,골목상권,독산로78다길,금천구,독산4동,1134501,19844,1514,765905,368599,595845,538655,9992,9852,948,566
2019년1분기,골목상권,독산로85길,금천구,독산3동,979774,14225,1509,684423,295351,537238,442540,7201,7024,703,806
2019년2분기,골목상권,독산로85길,금천구,독산3동,1178183,14225,1548,811986,366194,631708,546474,7201,7024,986,562
2019년1분기,골목상권,문성로5길,금천구,독산3동,1591873,21307,4161,1173115,418765,858399,733474,10833,10474,2650,1511
2019년2분기,골목상권,문성로5길,금천구,독산3동,1696613,21307,4652,1202566,494062,890116,806507,10833,10474,3245,1407
2019년1분기,골목상권,범안로11길,금천구,독산1동,653319,11340,34744,492994,160328,397432,255886,6244,5096,23080,11664
2019년2분기,골목상권,범안로11길,금천구,독산1동,778950,11340,24684,586792,192164,474258,304693,6244,5096,16820,7864
2019년1분기,골목상권,범안로17길,금천구,독산1동,583924,8859,11239,426999,156929,347481,236441,4876,3983,7660,3579
2019년2분기,골목상권,범안로17길,금천구,독산1동,691482,8859,9202,505649,185836,411358,280126,4876,3983,5914,3288
2019년1분기,골목상권,벚꽃로56길,금천구,가산동,580954,5990,73061,464697,116260,356274,224686,3280,2710,45471,27590
2019년2분기,골목상권,벚꽃로56길,금천구,가산동,719784,5990,57475,575798,143989,442256,277525,3280,2710,35620,21855
2019년1분기,골목상권,도림로6길,구로구,가리봉동,1545073,14754,11464,1101568,443506,873679,671403,7567,7187,6808,4656
2019년2분기,골목상권,도림로6길,구로구,가리봉동,1866514,14754,6586,1308238,558294,1041001,825514,7567,7187,4103,2483
2019년1분기,골목상권,디지털로27길,구로구,가리봉동,1617346,10705,40121,1266555,350781,979186,638163,5470,5235,24051,16070
2019년2분기,골목상권,디지털로27길,구로구,가리봉동,1978115,10705,28510,1534464,443663,1180095,798019,5470,5235,19539,8971
2019년1분기,골목상권,동남로82길,강동구,고덕2동,52127,4617,804,44486,7650,41726,10399,2456,2161,433,371
2019년2분기,골목상권,동남로82길,강동구,고덕2동,121743,4617,650,92248,29492,80199,41539,2456,2161,259,391
2019년1분기,골목상권,도봉산4길,도봉구,도봉1동,54882,3912,1298,27988,26900,32572,22311,1973,1939,981,317
2019년2분기,골목상권,도봉산4길,도봉구,도봉1동,88664,3912,1364,45123,43547,49229,39435,1973,1939,552,812
2019년2분기,골목상권,평창길,종로구,평창동,30233,8352,9451,22629,7602,8447,21787,3927,4425,5431,4020
2019년1분기,골목상권,평창길,종로구,평창동,21798,8352,1182,16558,5241,6261,15540,3927,4425,522,660
2019년1분기,골목상권,계동길,종로구,가회동,471903,5455,24345,359301,112607,253713,218188,2544,2911,19877,4468
2019년2분기,골목상권,계동길,종로구,가회동,638841,5455,7818,470491,168358,326643,312201,2544,2911,4892,2926
2019년1분기,골목상권,당산로37길,영등포구,당산2동,1426571,18023,34091,1102846,323728,767245,659336,8542,9481,14986,19105
2019년2분기,골목상권,당산로37길,영등포구,당산2동,1735341,18023,17655,1332548,402791,909840,825506,8542,9481,10007,7648
2019년1분기,골목상권,당산로38길,영등포구,당산2동,1409912,18023,22555,1069586,340322,754214,655705,8592,9431,11767,10788
2019년2분기,골목상권,당산로38길,영등포구,당산2동,1679219,18023,9714,1268350,410862,875522,803700,8592,9431,6175,3539
2019년1분기,골목상권,당산로46길,영등포구,당산2동,1626416,13468,11671,1192603,433822,867430,758988,6191,7277,7186,4485
2019년2분기,골목상권,당산로46길,영등포구,당산2동,2027853,13468,10918,1477231,550622,1075234,952620,6191,7277,7319,3599
2019년1분기,골목상권,대림로22길,영등포구,대림1동,1634599,17003,2540,1141245,493383,858599,775990,8547,8456,1220,1320
2019년2분기,골목상권,대림로22길,영등포구,대림1동,1949341,17003,3006,1344441,604904,1008696,940633,8547,8456,1594,1412
2019년1분기,골목상권,대림로34길,영등포구,대림3동,1421619,14127,5805,1039708,381940,779911,641706,7225,6902,3457,2348
2019년2분기,골목상권,대림로34길,영등포구,대림3동,1714153,14127,4611,1235777,478385,923290,790867,7225,6902,3212,1399
2019년1분기,골목상권,대림로29길,영등포구,대림3동,2267953,16176,4339,1563673,704307,1216607,1051344,8043,8133,2213,2126
2019년2분기,골목상권,대림로29길,영등포구,대림3동,2679890,16176,4098,1812433,867471,1423548,1256346,8043,8133,2329,1769
2019년1분기,골목상권,대림로31길,영등포구,대림3동,1593258,14454,14545,1144380,448896,880891,712369,7170,7284,9584,4961
2019년2분기,골목상권,대림로31길,영등포구,대림3동,1897642,14454,12608,1340518,557130,1029934,867716,7170,7284,8744,3864
2019년1분기,골목상권,중앙로15길,구로구,고척2동,756378,14948,1374,526142,230242,377828,378552,7401,7547,661,713
2019년2분기,골목상권,중앙로15길,구로구,고척2동,935284,14948,1990,633667,301620,465064,470218,7401,7547,1316,674
2019년1분기,골목상권,중앙로1길,구로구,고척1동,1086527,16408,4511,799615,286908,574244,512287,8036,8372,2593,1918
2019년2분기,골목상권,중앙로1길,구로구,고척1동,1379506,16408,4432,1027131,352369,766745,612756,8036,8372,2630,1802
2019년1분기,골목상권,가산로3길,금천구,독산1동,627167,12187,43301,471719,155451,382207,244958,6940,5247,29212,14089
2019년2분기,골목상권,가산로3길,금천구,독산1동,820728,12187,23142,622431,198309,504680,316054,6940,5247,15779,7363
2019년1분기,골목상권,가산로5길,금천구,가산동,1115489,16593,18750,827631,287863,651742,463748,9273,7320,12558,6192
2019년2분기,골목상권,가산로5길,금천구,가산동,1345974,16593,9489,994028,351951,787231,558741,9273,7320,5285,4204
2019년1분기,골목상권,금하로14길,금천구,시흥1동,1467224,13757,2701,1015238,452003,742956,724269,6944,6813,1234,1467
2019년2분기,골목상권,금하로14길,금천구,시흥1동,1853554,13757,1455,1308035,545525,943363,910186,6944,6813,693,762
2019년1분기,골목상권,대림로44길,영등포구,대림3동,1570710,17721,4573,1152707,418038,814552,756154,8934,8787,2911,1662
2019년2분기,골목상권,대림로44길,영등포구,대림3동,1696786,17721,8512,1228313,468470,877993,818797,8934,8787,4444,4068
2019년1분기,골목상권,대림로7길,영등포구,대림2동,1122580,11839,3029,777888,344697,566618,555960,5827,6012,1257,1772
2019년2분기,골목상권,대림로7길,영등포구,대림2동,1224072,11839,4992,834902,389175,617896,606180,5827,6012,2804,2188
2019년1분기,골목상권,대림로8길,영등포구,대림1동,1741301,20004,3608,1218681,522629,855915,885379,9871,10133,1358,2250
2019년2분기,골목상권,대림로8길,영등포구,대림1동,1977775,20004,4740,1370476,607298,958068,1019696,9871,10133,2360,2380
2019년1분기,골목상권,북촌로5나길,종로구,삼청동,182615,2947,5645,125690,56924,89671,92939,1382,1565,3612,2033
2019년2분기,골목상권,북촌로5나길,종로구,삼청동,246847,2947,9087,167374,79472,119910,126939,1382,1565,7537,1550
2019년1분기,골목상권,삼청로5길,종로구,삼청동,190629,2755,5338,130261,60370,92308,98317,1291,1464,3444,1894
2019년2분기,골목상권,삼청로5길,종로구,삼청동,260175,2755,8785,175107,85068,124632,135545,1291,1464,7414,1371
2019년1분기,골목상권,성균관로5길,종로구,혜화동,1959860,7228,14045,1349389,610478,942908,1016953,3374,3854,4934,9111
2019년2분기,골목상권,성균관로5길,종로구,혜화동,2363600,7228,1499,1634408,729205,1126802,1236799,3374,3854,939,560
2019년1분기,골목상권,지봉로8길,종로구,숭인1동,2206175,16319,3025,1598430,607740,1128759,1077408,8284,8035,1269,1756
2019년2분기,골목상권,지봉로8길,종로구,숭인1동,2577375,16319,2493,1835954,741443,1310506,1266876,8284,8035,1442,1051
2019년1분기,골목상권,창경궁로35길,종로구,혜화동,1545188,10127,2381,1083737,461449,741021,804164,4669,5458,1231,1150
2019년2분기,골목상권,창경궁로35길,종로구,혜화동,1884539,10127,3854,1314844,569701,891066,993471,4669,5458,1944,1910
2019년1분기,골목상권,창신2길,종로구,창신2동,1428085,10555,2332,1030114,397968,746953,681135,5637,4918,1155,1177
2019년2분기,골목상권,창신2길,종로구,창신2동,1602055,10555,806,1136673,465390,827769,774297,5637,4918,372,434
2019년1분기,골목상권,창신5길,종로구,창신2동,1937969,12294,2536,1402704,535262,989678,948294,6343,5951,962,1574
2019년2분기,골목상권,창신5길,종로구,창신2동,2170207,12294,1977,1542579,627640,1093587,1076627,6343,5951,1128,849
2019년1분기,골목상권,창신길,종로구,창신2동,1234637,15789,1338,877065,357554,632187,602451,8183,7606,451,887
2019년2분기,골목상권,창신길,종로구,창신2동,1410956,15789,665,978819,432146,716948,694012,8183,7606,234,431
2019년1분기,골목상권,통일로12길,종로구,교남동,960293,13726,1565,673637,286653,444247,516045,6438,7288,613,952
2019년2분기,골목상권,통일로12길,종로구,교남동,1263826,13726,1623,872230,391603,587569,676264,6438,7288,903,720
2019년1분기,골목상권,숭인동길,종로구,숭인2동,2122812,14441,6847,1538507,584308,1155047,967768,7325,7116,3368,3479
2019년2분기,골목상권,숭인동길,종로구,숭인2동,2554428,14441,8095,1852875,701547,1395599,1158824,7325,7116,3140,4955
2019년1분기,골목상권,옥인길,종로구,청운효자동,796819,8372,1899,584703,212116,357225,439599,3845,4527,862,1037
2019년2분기,골목상권,옥인길,종로구,청운효자동,857913,8372,1589,629174,228751,352836,505089,3845,4527,673,916
2019년1분기,골목상권,율곡로10길,종로구,종로1.2.3.4가동,1172123,2351,27532,841181,330935,649329,522791,1461,890,20919,6613
2019년2분기,골목상권,율곡로10길,종로구,종로1.2.3.4가동,1345961,2351,8187,958275,387686,742878,603083,1461,890,5391,2796
2019년1분기,골목상권,율곡로16길,종로구,종로5.6가동,1740581,6512,23379,1412452,328123,1005068,735511,3317,3195,10648,12731
2019년2분기,골목상권,율곡로16길,종로구,종로5.6가동,2129180,6512,8941,1727723,401452,1193546,935629,3317,3195,5638,3303
2019년1분기,골목상권,이화장길,종로구,이화동,2293086,10044,23221,1710848,582231,1163265,1129815,4930,5114,10158,13063
2019년2분기,골목상권,이화장길,종로구,이화동,2781967,10044,9785,2068495,713458,1362887,1419078,4930,5114,5862,3923
2019년1분기,골목상권,자하문로7길,종로구,사직동,1405721,8466,11104,1041929,363794,690386,715340,3892,4574,5822,5282
2019년2분기,골목상권,자하문로7길,종로구,사직동,1685828,8466,8233,1229386,456446,785433,900396,3892,4574,5850,2383
2019년1분기,골목상권,종로24길,종로구,종로1.2.3.4가동,1266918,1585,12506,990052,276867,774620,492296,1182,403,7735,4771
2019년2분기,골목상권,종로24길,종로구,종로1.2.3.4가동,1582177,1585,5817,1229314,352865,944445,637735,1182,403,3837,1980
2019년1분기,골목상권,종로58가길,종로구,숭인2동,2390422,6396,4398,1740542,649889,1251276,1139148,3292,3104,1862,2536
2019년2분기,골목상권,종로58가길,종로구,숭인2동,2785722,6396,2879,2014414,771309,1447662,1338058,3292,3104,1600,1279
2019년1분기,골목상권,종로65길,종로구,숭인2동,2827769,16702,5653,2027718,800063,1490398,1337370,8381,8321,2860,2793
2019년2분기,골목상권,종로65길,종로구,숭인2동,3316675,16702,3699,2352452,964227,1751404,1565272,8381,8321,2032,1667
2019년1분기,골목상권,난계로27길,종로구,숭인2동,2186033,11047,13270,1499105,686921,1237827,948202,5624,5423,6153,7117
2019년2분기,골목상권,난계로27길,종로구,숭인2동,2628926,11047,9366,1797640,831283,1482662,1146258,5624,5423,4453,4913
2019년1분기,골목상권,돈화문로11가길,종로구,종로1.2.3.4가동,1818586,3512,44890,1340682,477893,1015350,803234,2033,1479,32318,12572
2019년2분기,골목상권,돈화문로11가길,종로구,종로1.2.3.4가동,2117484,3512,32048,1543951,573534,1170579,946907,2033,1479,20069,11979
2019년1분기,골목상권,명륜길,종로구,혜화동,1208957,9137,2196,914237,294728,573717,635243,4521,4616,1194,1002
2019년2분기,골목상권,명륜길,종로구,혜화동,1665666,9137,1715,1281945,383731,787162,878508,4521,4616,999,716
2019년1분기,골목상권,백석동길,종로구,부암동,47589,6102,1820,30616,16966,22232,25363,2958,3144,994,826
2019년2분기,골목상권,백석동길,종로구,부암동,80216,6102,3651,50074,30154,39374,40845,2958,3144,2049,1602
2019년1분기,골목상권,북촌로11길,종로구,가회동,498589,4731,22845,365547,133041,253373,245210,2193,2538,18760,4085
2019년2분기,골목상권,북촌로11길,종로구,가회동,683408,4731,8584,488505,194900,333921,349486,2193,2538,6196,2388
2019년1분기,골목상권,북촌로5길,종로구,삼청동,532615,3243,7360,399283,133337,273289,259321,1499,1744,4379,2981
2019년2분기,골목상권,북촌로5길,종로구,삼청동,718958,3243,11176,525646,193318,352957,366001,1499,1744,8689,2487
2019년1분기,골목상권,청구로17길,중구,다산동,2301183,11428,13278,1732774,568407,1168718,1132462,5514,5914,6709,6569
2019년2분기,골목상권,청구로17길,중구,다산동,2695540,11428,8917,2019380,676159,1362020,1333524,5514,5914,4286,4631
2019년1분기,골목상권,청구로1길,중구,청구동,1311650,17672,4470,969726,341930,630856,680798,8486,9186,2410,2060
2019년2분기,골목상권,청구로1길,중구,청구동,1527917,17672,3813,1122848,405073,741792,786131,8486,9186,1941,1872
2019년1분기,골목상권,퇴계로12길,중구,회현동,1193394,4937,27804,929821,263574,527048,666344,2421,2516,13761,14043
2019년2분기,골목상권,퇴계로12길,중구,회현동,1538153,4937,15202,1203225,334929,648020,890130,2421,2516,9708,5494
2019년1분기,골목상권,퇴계로18길,중구,명동,745413,3463,36728,576030,169390,355751,389663,1669,1794,15290,21438
2019년2분기,골목상권,퇴계로18길,중구,명동,966999,3463,22616,749363,217638,436997,530003,1669,1794,10493,12123
2019년1분기,골목상권,퇴계로46길,중구,장충동,1504717,5740,13011,1225521,279188,837695,667017,3009,2731,7574,5437
2019년2분기,골목상권,퇴계로46길,중구,장충동,1881223,5740,8076,1543733,337486,1038481,842741,3009,2731,4975,3101
2019년1분기,골목상권,퇴계로56길,중구,장충동,1602624,5999,30673,1260537,342083,858975,743647,3109,2890,15330,15343
2019년2분기,골목상권,퇴계로56길,중구,장충동,1977940,5999,46645,1556413,421532,1049109,928827,3109,2890,23056,23589
2019년1분기,골목상권,필운대로1길,종로구,사직동,1105673,10610,6750,813665,292009,516409,589269,4833,5777,2908,3842
2019년2분기,골목상권,필운대로1길,종로구,사직동,1352314,10610,3174,984534,367779,594314,758004,4833,5777,1811,1363
2019년1분기,골목상권,난계로11길,중구,황학동,1873390,16470,4623,1385376,488034,956618,916776,8027,8443,2344,2279
2019년2분기,골목상권,난계로11길,중구,황학동,2288758,16470,2999,1685139,603620,1144895,1143869,8027,8443,1490,1509
2019년1분기,골목상권,난계로21길,중구,황학동,1354643,15622,5013,943015,411638,695831,658811,7531,8091,2683,2330
2019년2분기,골목상권,난계로21길,중구,황학동,1631028,15622,2829,1130877,500146,825504,805530,7531,8091,1524,1305
2019년1분기,골목상권,다산로33길,중구,신당동,2267394,12661,9534,1719767,547632,1180731,1086660,6393,6268,4463,5071
2019년2분기,골목상권,다산로33길,중구,신당동,2681209,12661,5551,2014404,666813,1398316,1282891,6393,6268,2806,2745
2019년1분기,골목상권,다산로36길,중구,동화동,1344410,19797,2890,978661,365745,689642,654774,9615,10182,1388,1502
2019년2분기,골목상권,다산로36길,중구,동화동,1610412,19797,2292,1161257,449154,819148,791257,9615,10182,1099,1193
2019년1분기,골목상권,다산로38길,중구,동화동,2399996,13196,7667,1798106,601896,1258320,1141682,6654,6542,3783,3884
2019년2분기,골목상권,다산로38길,중구,동화동,2851863,13196,2383,2115418,736445,1480092,1371762,6654,6542,1106,1277
2019년1분기,골목상권,다산로39길,중구,신당동,2173269,8801,8877,1660258,513012,1143176,1030093,4475,4326,4200,4677
2019년2분기,골목상권,다산로39길,중구,신당동,2573682,8801,2826,1949741,623954,1349871,1223808,4475,4326,1434,1392
2019년1분기,골목상권,동호로10길,중구,청구동,2347944,16692,9643,1756943,590998,1181119,1166824,7981,8711,4691,4952
2019년2분기,골목상권,동호로10길,중구,청구동,2766778,16692,7227,2057752,709024,1390074,1376712,7981,8711,3495,3732
2019년1분기,골목상권,동호로11길,중구,다산동,1142350,16945,8384,848266,294079,573958,568397,8140,8805,3931,4453
2019년2분기,골목상권,동호로11길,중구,다산동,1356662,16945,4771,998891,357761,684059,672605,8140,8805,3096,1675
2019년1분기,골목상권,동호로15길,중구,다산동,2200182,12165,12874,1644621,555555,1121271,1078913,5778,6387,6144,6730
2019년2분기,골목상권,동호로15길,중구,다산동,2567563,12165,7862,1908964,658600,1296328,1271242,5778,6387,3823,4039
2019년1분기,골목상권,동호로20길,중구,장충동,1897420,10940,13400,1437502,459909,992718,904698,5363,5577,7311,6089
2019년2분기,골목상권,동호로20길,중구,장충동,2314017,10940,13565,1746736,567277,1198250,1115766,5363,5577,6708,6857
2019년1분기,골목상권,동호로8길,중구,약수동,2103728,15767,7383,1562159,541565,1064693,1039030,7490,8277,3315,4068
2019년2분기,골목상권,동호로8길,중구,약수동,2481426,15767,4385,1832500,648933,1247803,1233628,7490,8277,2201,2184
2019년1분기,골목상권,명동길,중구,명동,3638769,1426,159325,2886007,752757,1856269,1782497,532,894,79755,79570
2019년2분기,골목상권,명동길,중구,명동,4415062,1426,96337,3488384,926681,2193832,2221230,532,894,44858,51479
2019년1분기,골목상권,삼일대로4길,중구,을지로동,2085443,1955,75486,1724545,360894,1195311,890127,821,1134,37420,38066
2019년2분기,골목상권,삼일대로4길,중구,을지로동,2541633,1955,38834,2082945,458690,1416273,1125361,821,1134,17323,21511
2019년1분기,골목상권,장충단로8길,중구,장충동,1296126,9718,8955,982217,313901,676977,619142,4862,4856,5290,3665
2019년2분기,골목상권,장충단로8길,중구,장충동,1602150,9718,10694,1206914,395244,829659,772486,4862,4856,5642,5052
2019년1분기,골목상권,녹사평대로46길,용산구,이태원2동,721042,6804,4204,484303,236740,349299,371747,3203,3601,2064,2140
2019년2분기,골목상권,녹사평대로46길,용산구,이태원2동,1076821,6804,9940,720868,355960,518679,558141,3203,3601,3957,5983
2019년1분기,골목상권,대사관로34길,용산구,한남동,1322415,9880,5556,983277,339133,654969,667445,4980,4900,2861,2695
2019년2분기,골목상권,대사관로34길,용산구,한남동,1660300,9880,6992,1227661,432648,820100,840198,4980,4900,4578,2414
2019년1분기,골목상권,두텁바위로1길,용산구,남영동,1388356,16262,12369,1005716,382631,735406,652942,8437,7825,6375,5994
2019년2분기,골목상권,두텁바위로1길,용산구,남영동,1712843,16262,7955,1234176,478677,891586,821258,8437,7825,4940,3015
2019년1분기,골목상권,원효로41길,용산구,원효로2동,733107,13007,15765,546150,186955,415043,318070,6277,6730,9646,6119
2019년2분기,골목상권,원효로41길,용산구,원효로2동,880146,13007,6756,647273,232867,494203,385941,6277,6730,4811,1945
2019년1분기,골목상권,원효로53길,용산구,용문동,1582874,13258,10081,1210043,372836,916925,665959,6545,6713,6777,3304
2019년2분기,골목상권,원효로53길,용산구,용문동,2056295,13258,6718,1561984,494303,1144599,911698,6545,6713,4773,1945
2019년1분기,골목상권,원효로89길,용산구,원효로1동,1973178,10436,26676,1505021,468172,961295,1011887,4959,5477,12967,13709
2019년2분기,골목상권,원효로89길,용산구,원효로1동,2485294,10436,11112,1893777,591517,1159782,1325509,4959,5477,6713,4399
2019년1분기,골목상권,이촌로22길,용산구,이촌2동,263879,8788,9172,190145,73739,148087,115790,4183,4605,4945,4227
2019년2분기,골목상권,이촌로22길,용산구,이촌2동,271475,8788,2407,191308,80167,151006,120468,4183,4605,1488,919
2019년1분기,골목상권,이태원로27길,용산구,이태원1동,2216889,9038,9790,1339990,876892,1158130,1058766,4373,4665,5390,4400
2019년2분기,골목상권,이태원로27길,용산구,이태원1동,2972659,9038,18297,1773690,1198965,1527442,1445224,4373,4665,9048,9249
2019년1분기,골목상권,이태원로54길,용산구,한남동,1532605,7198,10780,1047154,485459,784120,748481,3455,3743,5518,5262
2019년2분기,골목상권,이태원로54길,용산구,한남동,1892158,7198,14402,1276050,616119,965863,926290,3455,3743,9024,5378
2019년1분기,골목상권,백범로79길,용산구,효창동,1998317,15495,13752,1535269,463058,1022214,976100,7359,8136,5689,8063
2019년2분기,골목상권,백범로79길,용산구,효창동,2419899,15495,4674,1839308,580594,1162005,1257889,7359,8136,3023,1651
2019년1분기,골목상권,백범로90길,용산구,원효로1동,1751840,13181,21952,1348768,403076,923433,828408,6345,6836,10470,11482
2019년2분기,골목상권,백범로90길,용산구,원효로1동,2169990,13181,9066,1655666,514323,1115467,1054519,6345,6836,5401,3665
2019년1분기,골목상권,서빙고로71길,용산구,서빙고동,263958,10861,3589,192721,71243,151809,112150,5320,5541,1918,1671
2019년2분기,골목상권,서빙고로71길,용산구,서빙고동,319883,10861,5610,229140,90742,179772,140117,5320,5541,3274,2336
2019년1분기,골목상권,소월로20길,용산구,용산2가동,760197,11513,3753,512418,247781,374570,385626,5547,5966,1828,1925
2019년2분기,골목상권,소월로20길,용산구,용산2가동,982498,11513,2168,652016,330473,475587,506906,5547,5966,1491,677
2019년1분기,골목상권,신흥로20길,용산구,후암동,685048,14714,5222,474871,210182,342253,342788,7143,7571,2507,2715
2019년2분기,골목상권,신흥로20길,용산구,후암동,876842,14714,2776,596115,280730,428422,448409,7143,7571,1769,1007
2019년1분기,골목상권,우사단로10길,용산구,보광동,2216213,18833,6345,1470649,745567,1190807,1025418,9305,9528,2934,3411
2019년2분기,골목상권,우사단로10길,용산구,보광동,2748681,18833,6573,1795989,952697,1475444,1273237,9305,9528,3335,3238
2019년1분기,골목상권,우사단로14길,용산구,한남동,1908110,12088,5927,1203254,704858,1049838,858279,5848,6240,3273,2654
2019년2분기,골목상권,우사단로14길,용산구,한남동,2372872,12088,7298,1465425,907442,1294498,1078366,5848,6240,3998,3300
2019년1분기,골목상권,우사단로4길,용산구,보광동,1342021,16069,1300,877692,464336,757651,584377,7883,8186,746,554
2019년2분기,골목상권,우사단로4길,용산구,보광동,1639026,16069,2678,1053325,585711,924234,714793,7883,8186,1501,1177
2019년1분기,골목상권,원효로19길,용산구,원효로2동,779683,14138,16922,588742,190941,428019,351676,6649,7489,10437,6485
2019년2분기,골목상권,원효로19길,용산구,원효로2동,930685,14138,8398,686236,244439,516670,414011,6649,7489,5866,2532
2019년1분기,골목상권,퇴계로8길,중구,회현동,1541870,4290,50117,1260089,281783,748739,793129,2155,2135,29933,20184
2019년2분기,골목상권,퇴계로8길,중구,회현동,1954317,4290,24169,1601419,352896,914809,1039506,2155,2135,15527,8642
2019년1분기,골목상권,퇴계로90길,중구,신당5동,2075542,22459,5017,1545800,529750,1075653,999898,10946,11513,2619,2398
2019년2분기,골목상권,퇴계로90길,중구,신당5동,2527573,22459,2588,1865931,661635,1282877,1244688,10946,11513,1366,1222
2019년1분기,골목상권,녹사평대로11길,용산구,서빙고동,126495,6361,2747,92854,33644,71585,54910,3075,3286,1471,1276
2019년2분기,골목상권,녹사평대로11길,용산구,서빙고동,147552,6361,2024,105619,41929,80185,67369,3075,3286,1130,894
2019년1분기,골목상권,녹사평대로26길,용산구,이태원1동,1663578,7307,7264,957652,705913,900232,763348,3483,3824,4027,3237
2019년2분기,골목상권,녹사평대로26길,용산구,이태원1동,2111278,7307,5623,1188316,922958,1122987,988297,3483,3824,3499,2124
2019년1분기,골목상권,녹사평대로32길,용산구,이태원1동,1433649,5120,5325,827807,605835,749722,683931,2453,2667,2986,2339
2019년2분기,골목상권,녹사평대로32길,용산구,이태원1동,1949313,5120,1986,1118721,830587,995348,953971,2453,2667,1110,876
2019년1분기,골목상권,녹사평대로40나길,용산구,이태원2동,889110,4280,6792,536261,352843,446711,442400,2101,2179,3472,3320
2019년2분기,골목상권,녹사평대로40나길,용산구,이태원2동,1308069,4280,1251,793161,514915,642410,665663,2101,2179,721,530
2019년1분기,골목상권,후암로28길,용산구,후암동,821850,17280,6036,595555,226302,440545,381297,8413,8867,2917,3119
2019년2분기,골목상권,후암로28길,용산구,후암동,1010724,17280,3274,717405,293342,532629,478100,8413,8867,2099,1175
2019년1분기,골목상권,고산자로6길,성동구,행당1동,2257305,23581,9931,1603677,653630,1122748,1134553,11357,12224,4828,5103
2019년2분기,골목상권,고산자로6길,성동구,행당1동,2695863,23581,11694,1897351,798514,1327923,1367951,11357,12224,4963,6731
2019년1분기,골목상권,금호산2길,성동구,금호2.3가동,1529610,19699,1570,1073538,456097,757751,771864,9480,10219,613,957
2019년2분기,골목상권,금호산2길,성동구,금호2.3가동,1705975,19699,3237,1176795,529197,827818,878158,9480,10219,1364,1873
2019년1분기,골목상권,금호산길,성동구,금호2.3가동,2032982,24553,1669,1443020,589992,979582,1053409,11734,12819,663,1006
2019년2분기,골목상권,금호산길,성동구,금호2.3가동,2285863,24553,1615,1596576,689285,1079359,1206506,11734,12819,868,747
2019년1분기,골목상권,둘레9길,성동구,성수1가1동,895012,15403,33878,652231,242785,498711,396304,8059,7344,13431,20447
2019년2분기,골목상권,둘레9길,성동구,성수1가1동,1098562,15403,3334,785231,313334,606688,491876,8059,7344,2398,936
2019년1분기,골목상권,뚝섬로5길,성동구,성수2가1동,1161402,11056,58712,935084,226330,665716,495676,5672,5384,26727,31985
2019년2분기,골목상권,뚝섬로5길,성동구,성수2가1동,1482398,11056,9107,1173798,308599,819347,663049,5672,5384,5815,3292
2019년1분기,골목상권,장문로45길,용산구,보광동,1200778,18284,1171,825937,374842,657925,542856,9084,9200,625,546
2019년2분기,골목상권,장문로45길,용산구,보광동,1483255,18284,3839,1003675,479582,808242,675019,9084,9200,2662,1177
2019년1분기,골목상권,청파로47길,용산구,청파동,1924819,10418,14567,1444036,480778,770839,1153976,4676,5742,7529,7038
2019년2분기,골목상권,청파로47길,용산구,청파동,2499041,10418,11070,1903710,595321,908319,1590722,4676,5742,6421,4649
2019년1분기,골목상권,청파로47나길,용산구,청파동,2192663,14254,8965,1619219,573439,865890,1326773,6868,7386,4855,4110
2019년2분기,골목상권,청파로47나길,용산구,청파동,2836636,14254,6299,2125818,710818,1018050,1818590,6868,7386,3747,2552
2019년1분기,골목상권,청파로71길,용산구,청파동,1724740,19669,10077,1283831,440895,772700,952040,9926,9743,4734,5343
2019년2분기,골목상권,청파로71길,용산구,청파동,2238334,19669,6760,1678579,559761,944629,1293713,9926,9743,4051,2709
2019년1분기,골목상권,청파로73길,용산구,청파동,1198367,12315,7644,881780,316587,655331,543038,6350,5965,4456,3188
2019년2분기,골목상권,청파로73길,용산구,청파동,1446656,12315,4225,1054558,392098,774673,671985,6350,5965,2730,1495
2019년1분기,골목상권,한강대로104길,용산구,남영동,1179929,16093,54025,879411,300515,653189,526735,8770,7323,30252,23773
2019년2분기,골목상권,한강대로104길,용산구,남영동,1421884,16093,25525,1048944,372959,778634,643255,8770,7323,13524,12001
2019년1분기,골목상권,한강대로15길,용산구,한강로동,321910,3644,23870,235049,86860,184238,137669,1813,1831,15623,8247
2019년2분기,골목상권,한강대로15길,용산구,한강로동,396022,3644,8262,284639,111386,226878,169149,1813,1831,4685,3577
2019년1분기,골목상권,한강대로43길,용산구,한강로동,1125428,5566,46231,894372,231056,649184,476250,2698,2868,23060,23171
2019년2분기,골목상권,한강대로43길,용산구,한강로동,1315962,5566,30446,1022865,293096,745712,570249,2698,2868,12591,17855
2019년1분기,골목상권,한강대로52길,용산구,한강로동,999335,4464,33148,795587,203747,580122,419215,2225,2239,15409,17739
2019년2분기,골목상권,한강대로52길,용산구,한강로동,1129052,4464,25037,876732,252321,638436,490616,2225,2239,9472,15565
2019년1분기,골목상권,한강대로62길,용산구,한강로동,920280,4600,11320,722670,197610,531537,388746,2292,2308,7804,3516
2019년2분기,골목상권,한강대로62길,용산구,한강로동,1034120,4600,14819,785923,248200,580143,453980,2292,2308,7117,7702
2019년1분기,골목상권,한강대로7길,용산구,한강로동,398141,7129,22178,283452,114686,221940,176196,3522,3607,14586,7592
2019년2분기,골목상권,한강대로7길,용산구,한강로동,430444,7129,9292,302832,127617,240018,190430,3522,3607,5426,3866
2019년1분기,골목상권,한강대로88길,용산구,남영동,627859,3937,6640,455551,172299,330267,297590,2173,1764,3400,3240
2019년2분기,골목상권,한강대로88길,용산구,남영동,782748,3937,3532,570938,211814,397646,385103,2173,1764,1948,1584
2019년1분기,골목상권,한남대로20길,용산구,한남동,1015973,5098,8040,770274,245697,478056,537917,2430,2668,4195,3845
2019년2분기,골목상권,한남대로20길,용산구,한남동,1257157,5098,19793,948849,308308,587045,670114,2430,2668,14956,4837
2019년1분기,골목상권,회나무로13길,용산구,이태원2동,1001323,10174,4972,668626,332713,485571,515762,4717,5457,2552,2420
2019년2분기,골목상권,회나무로13길,용산구,이태원2동,1296388,10174,2914,845984,450407,629938,666457,4717,5457,1396,1518
2019년1분기,골목상권,효창원로39길,용산구,용문동,1422528,18790,1974,1031212,391314,759357,663178,9072,9718,1034,940
2019년2분기,골목상권,효창원로39길,용산구,용문동,1543896,18790,5010,1098999,444893,791911,751982,9072,9718,3124,1886
2019년1분기,골목상권,무학로6길,성동구,왕십리도선동,2022897,18638,9261,1469408,553507,1034993,987910,9101,9537,5075,4186
2019년2분기,골목상권,무학로6길,성동구,왕십리도선동,2450225,18638,4173,1761799,688438,1222347,1227881,9101,9537,2255,1918
2019년1분기,골목상권,무학봉28길,성동구,왕십리2동,1735404,13212,6826,1255570,479842,850510,884901,6517,6695,3496,3330
2019년2분기,골목상권,무학봉28길,성동구,왕십리2동,2031477,13212,3439,1454292,577196,970021,1061451,6517,6695,1892,1547
2019년1분기,골목상권,무학봉길,성동구,왕십리2동,1456396,24551,1475,1031199,425201,687794,768599,11896,12655,593,882
2019년2분기,골목상권,무학봉길,성동구,왕십리2동,1741542,24551,1160,1210238,531330,806941,934600,11896,12655,589,571
2019년1분기,골목상권,송정12라길,성동구,송정동,1248403,11894,1465,910652,337729,673374,575021,6210,5684,717,748
2019년2분기,골목상권,송정12라길,성동구,송정동,1531807,11894,1178,1120601,411208,822047,709762,6210,5684,607,571
2019년1분기,골목상권,송정4가길,성동구,송정동,1358963,11431,12547,1013607,345357,751729,607229,5966,5465,7636,4911
2019년2분기,골목상권,송정4가길,성동구,송정동,1674076,11431,6406,1236905,437174,922885,751193,5966,5465,4057,2349
2019년1분기,골목상권,아차산로11길,성동구,성수2가3동,1437219,5580,30097,1177487,259733,845968,591244,2804,2776,18222,11875
2019년2분기,골목상권,아차산로11길,성동구,성수2가3동,1751130,5580,18052,1426087,325043,996590,754535,2804,2776,11601,6451
2019년1분기,골목상권,아차산로15길,성동구,성수2가3동,1580634,8980,25047,1234376,346250,899992,680634,4574,4406,15338,9709
2019년2분기,골목상권,아차산로15길,성동구,성수2가3동,1891110,8980,12658,1462337,428778,1070459,820644,4574,4406,8502,4156
2019년1분기,골목상권,아차산로5길,성동구,성수2가3동,1579517,10887,33395,1286352,293176,929042,650474,5478,5409,18340,15055
2019년2분기,골목상권,아차산로5길,성동구,성수2가3동,1934061,10887,10565,1568723,365333,1107009,827043,5478,5409,6501,4064
2019년1분기,골목상권,왕십리로14길,성동구,성수1가2동,1646732,13028,16569,1303326,343413,941905,704830,6521,6507,9869,6700
2019년2분기,골목상권,왕십리로14길,성동구,성수1가2동,2241526,13028,5704,1706903,534620,1219372,1022162,6521,6507,3767,1937
2019년1분기,골목상권,사근동길,성동구,사근동,1043684,9957,7462,762004,281682,533472,510208,5171,4786,3626,3836
2019년2분기,골목상권,사근동길,성동구,사근동,1237211,9957,2734,913535,323683,616386,620830,5171,4786,1878,856
2019년1분기,골목상권,상원12길,성동구,성수1가2동,811823,9982,15431,649956,161878,468834,342990,4993,4989,9227,6204
2019년2분기,골목상권,상원12길,성동구,성수1가2동,1017484,9982,5148,805247,212222,572022,445461,4993,4989,3434,1714
2019년1분기,골목상권,상원길,성동구,성수1가2동,1280619,13669,30123,1045664,234971,734440,546184,6852,6817,16326,13797
2019년2분기,골목상권,상원길,성동구,성수1가2동,1649460,13669,8493,1329123,320328,920208,729250,6852,6817,5295,3198
2019년1분기,골목상권,서울숲2길,성동구,성수1가2동,1112170,7158,7418,854328,257852,620034,492138,3545,3613,4488,2930
2019년2분기,골목상권,서울숲2길,성동구,성수1가2동,1688679,7158,2910,1205223,483474,864815,823872,3545,3613,1865,1045
2019년1분기,골목상권,성덕정17길,성동구,성수2가1동,1523528,16790,37415,1113889,409645,857717,665809,8763,8027,15718,21697
2019년2분기,골목상권,성덕정17길,성동구,성수2가1동,1808271,16790,5531,1305848,502428,996546,811735,8763,8027,3833,1698
2019년1분기,골목상권,성덕정길,성동구,성수1가1동,630065,15687,35179,464952,165129,348943,281113,7941,7746,14361,20818
2019년2분기,골목상권,성덕정길,성동구,성수1가1동,784515,15687,2778,560337,224177,426901,357610,7941,7746,1904,874
2019년1분기,골목상권,성수이로18길,성동구,성수2가3동,1848222,7170,27076,1446197,402020,1057449,790770,3805,3365,16677,10399
2019년2분기,골목상권,성수이로18길,성동구,성수2가3동,2178148,7170,17664,1689749,488397,1210058,968089,3805,3365,11267,6397
2019년1분기,골목상권,성수이로7길,성동구,성수2가3동,1681506,7982,57714,1333514,348002,966056,715447,4155,3827,26163,31551
2019년2분기,골목상권,성수이로7길,성동구,성수2가3동,2026173,7982,13468,1595726,430447,1119051,907129,4155,3827,8240,5228
2019년1분기,골목상권,성수일로6길,성동구,성수2가3동,2091932,10000,44749,1711046,380895,1216235,875689,5082,4918,24947,19802
2019년2분기,골목상권,성수일로6길,성동구,성수2가3동,2535799,10000,20314,2061533,474261,1423763,1112031,5082,4918,12638,7676
2019년1분기,골목상권,마장로27길,성동구,마장동,1474424,14780,12883,1082063,392385,777777,696646,7336,7444,8078,4805
2019년2분기,골목상권,마장로27길,성동구,마장동,1885691,14780,3653,1367246,518468,973207,912496,7336,7444,2056,1597
2019년1분기,골목상권,마장로39길,성동구,마장동,758940,13170,3070,545597,213348,408380,350556,6505,6665,1982,1088
2019년2분기,골목상권,마장로39길,성동구,마장동,923929,13170,1704,655744,268189,484964,438970,6505,6665,1111,593
2019년1분기,골목상권,마조로16길,성동구,마장동,1054107,16433,2806,755257,298855,538960,515146,8211,8222,1716,1090
2019년2분기,골목상권,마조로16길,성동구,마장동,1266510,16433,1743,897960,368559,633332,633186,8211,8222,1064,679
2019년1분기,골목상권,마조로1길,성동구,사근동,1923284,9316,11138,1362528,560762,958187,965094,4583,4733,5745,5393
2019년2분기,골목상권,마조로1길,성동구,사근동,2284375,9316,3894,1610994,673382,1133415,1150962,4583,4733,2688,1206
2019년1분기,골목상권,매봉길,성동구,옥수동,929677,32574,1764,653594,276086,438237,491438,15352,17222,750,1014
2019년2분기,골목상권,매봉길,성동구,옥수동,1074462,32574,786,745211,329245,499769,574691,15352,17222,408,378
2019년1분기,골목상권,무수막길,성동구,금호2.3가동,1759399,19352,1218,1248051,511383,849742,909665,9281,10071,473,745
2019년2분기,골목상권,무수막길,성동구,금호2.3가동,1993263,19352,1020,1388143,605113,940083,1053173,9281,10071,557,463
2019년1분기,골목상권,광나루로52길,광진구,구의3동,2252558,24763,10178,1563002,689564,1111507,1141053,11861,12902,5587,4591
2019년2분기,골목상권,광나루로52길,광진구,구의3동,2706984,24763,10641,1848948,858055,1312491,1394504,11861,12902,5932,4709
2019년1분기,골목상권,긴고랑로20길,광진구,중곡2동,2642283,30766,3797,1888448,753848,1348274,1294010,14962,15804,1708,2089
2019년2분기,골목상권,긴고랑로20길,광진구,중곡2동,3265135,30766,3084,2315433,949690,1644513,1620616,14962,15804,1688,1396
2019년1분기,골목상권,긴고랑로7길,광진구,중곡1동,1502552,22979,3329,1057057,445488,767618,734930,11451,11528,1658,1671
2019년2분기,골목상권,긴고랑로7길,광진구,중곡1동,1875391,22979,2796,1301710,573672,942495,932898,11451,11528,1753,1043
2019년1분기,골목상권,긴고랑로8길,광진구,중곡1동,1032547,16349,3969,732579,299968,536464,496085,8068,8281,2085,1884
2019년2분기,골목상권,긴고랑로8길,광진구,중곡1동,1340624,16349,3548,944263,396359,677340,663282,8068,8281,2229,1319
2019년1분기,골목상권,긴고랑로9길,광진구,중곡3동,1453760,22011,3214,1023927,429818,743700,710048,10818,11193,1328,1886
2019년2분기,골목상권,긴고랑로9길,광진구,중곡3동,1815468,22011,1796,1266504,548959,914804,900663,10818,11193,1020,776
2019년1분기,골목상권,능동로13길,광진구,화양동,4315420,19517,9580,2989901,1325504,2232785,2082636,9362,10155,4943,4637
2019년2분기,골목상권,능동로13길,광진구,화양동,5138933,19517,4765,3511952,1626988,2615767,2523163,9362,10155,3073,1692
2019년1분기,골목상권,왕십리로21길,성동구,행당1동,1606035,21322,2947,1131846,474194,759430,846601,10194,11128,1227,1720
2019년2분기,골목상권,왕십리로21길,성동구,행당1동,1897986,21322,8415,1319338,578669,885933,1012056,10194,11128,2654,5761
2019년1분기,골목상권,왕십리로26길,성동구,왕십리도선동,2645462,17626,11724,1914519,730960,1317563,1327901,8590,9036,6200,5524
2019년2분기,골목상권,왕십리로26길,성동구,왕십리도선동,3164622,17626,5356,2265205,899433,1540026,1624596,8590,9036,3035,2321
2019년1분기,골목상권,왕십리로31길,성동구,왕십리2동,1429496,23671,4770,1041169,388338,695534,733978,11447,12224,2307,2463
2019년2분기,골목상권,왕십리로31길,성동구,왕십리2동,1710267,23671,3269,1227094,483188,804973,905285,11447,12224,1577,1692
2019년1분기,골목상권,왕십리로6길,성동구,성수1가2동,1873299,13354,30716,1499389,373918,1060864,812438,6643,6711,16912,13804
2019년2분기,골목상권,왕십리로6길,성동구,성수1가2동,2534344,13354,8279,1947575,586780,1359744,1174611,6643,6711,5192,3087
2019년1분기,골목상권,용답29길,성동구,용답동,1947879,18339,25249,1429303,518589,1026183,921693,9352,8987,20572,4677
2019년2분기,골목상권,용답29길,성동구,용답동,2172525,18339,8434,1581322,591205,1128801,1043716,9352,8987,4507,3927
2019년1분기,골목상권,용답중앙길,성동구,용답동,1295979,13150,4577,950757,345233,675462,620503,6614,6536,2409,2168
2019년2분기,골목상권,용답중앙길,성동구,용답동,1414187,13150,6266,1029912,384272,720482,693701,6614,6536,2892,3374
2019년1분기,골목상권,장터길,성동구,금호2.3가동,1461959,25797,1171,1032735,429243,725651,736313,12346,13451,436,735
2019년2분기,골목상권,장터길,성동구,금호2.3가동,1588671,25797,1048,1105331,483344,772317,816355,12346,13451,452,596
2019년1분기,골목상권,청계천로10나길,성동구,마장동,873051,15765,12953,662673,210395,476789,396267,7779,7986,8082,4871
2019년2분기,골목상권,청계천로10나길,성동구,마장동,1151428,15765,4806,857295,294144,615147,536291,7779,7986,2824,1982
2019년1분기,골목상권,한림말3길,성동구,옥수동,928933,17723,1364,671427,257506,431833,497099,8357,9366,561,803
2019년2분기,골목상권,한림말3길,성동구,옥수동,1105379,17723,4469,789266,316120,506833,598546,8357,9366,1851,2618
2019년1분기,골목상권,한림말길,성동구,옥수동,998594,16031,1861,720069,278532,457699,540898,7479,8552,808,1053
2019년2분기,골목상권,한림말길,성동구,옥수동,1142268,16031,14686,818064,324211,518979,623288,7479,8552,10526,4160
2019년1분기,골목상권,광나루로12길,광진구,화양동,2415796,16207,6290,1720609,695184,1274861,1140932,8014,8193,3755,2535
2019년2분기,골목상권,광나루로12길,광진구,화양동,2930669,16207,3432,2068801,861878,1543120,1387550,8014,8193,2108,1324
2019년1분기,골목상권,광나루로24길,광진구,화양동,954302,4773,4327,685880,268429,484558,469748,2321,2452,1851,2476
2019년2분기,골목상권,광나루로24길,광진구,화양동,1250944,4773,1341,915426,335530,628278,622672,2321,2452,966,375
2019년1분기,골목상권,광나루로36길,광진구,구의1동,1196556,17274,3597,860161,336394,605905,590641,8363,8911,2179,1418
2019년2분기,골목상권,광나루로36길,광진구,구의1동,1556073,17274,2612,1110646,445425,771996,784073,8363,8911,1733,879
2019년1분기,골목상권,광나루로37길,광진구,구의2동,976397,12645,2418,704709,271693,480299,496102,6220,6425,1239,1179
2019년2분기,골목상권,광나루로37길,광진구,구의2동,1378295,12645,2204,988035,390267,666033,712264,6220,6425,1170,1034
2019년1분기,골목상권,광나루로40길,광진구,구의1동,1815954,19408,2184,1260181,555785,887860,928090,9306,10102,1056,1128
2019년2분기,골목상권,광나루로40길,광진구,구의1동,2222689,19408,2549,1522037,700652,1073076,1149617,9306,10102,1398,1151
2019년1분기,골목상권,뚝섬로23길,광진구,자양3동,2029818,16748,3273,1413407,616416,1012179,1017632,8333,8415,1739,1534
2019년2분기,골목상권,뚝섬로23길,광진구,자양3동,2068899,16748,1746,1421726,647177,1015091,1053811,8333,8415,1076,670
2019년1분기,골목상권,뚝섬로24길,광진구,자양4동,1152234,13826,1520,809224,343023,611700,540528,6978,6848,917,603
2019년2분기,골목상권,뚝섬로24길,광진구,자양4동,1478114,13826,786,1009324,468802,750680,727446,6978,6848,546,240
2019년1분기,골목상권,뚝섬로48길,광진구,자양2동,1520598,21087,2118,1071040,449551,775138,745459,10371,10716,939,1179
2019년2분기,골목상권,뚝섬로48길,광진구,자양2동,1855007,21087,2029,1281129,573889,928512,926494,10371,10716,1271,758
2019년1분기,골목상권,용마산로21길,광진구,중곡2동,1897428,25830,4152,1359716,537725,955469,941946,12702,13128,1889,2263
2019년2분기,골목상권,용마산로21길,광진구,중곡2동,2372031,25830,2846,1683695,688333,1181549,1190473,12702,13128,1548,1298
2019년1분기,골목상권,용마산로3길,광진구,중곡2동,1929042,21097,5244,1391589,537462,974892,954150,10064,11033,2657,2587
2019년2분기,골목상권,용마산로3길,광진구,중곡2동,2358390,21097,4311,1689032,669345,1168553,1189828,10064,11033,2442,1869
2019년1분기,골목상권,자양로11길,광진구,자양1동,2419756,20416,8047,1745291,674481,1247128,1172634,9779,10637,5016,3031
2019년2분기,골목상권,자양로11길,광진구,자양1동,2792027,20416,4582,1998063,793992,1411060,1380975,9779,10637,2554,2028
2019년1분기,골목상권,자양로15길,광진구,자양1동,2229187,18420,12753,1603861,625335,1144421,1084770,8872,9548,7413,5340
2019년2분기,골목상권,자양로15길,광진구,자양1동,2653334,18420,13989,1894578,758762,1339675,1313657,8872,9548,10432,3557
2019년1분기,골목상권,자양로26길,광진구,구의1동,1876113,26478,5263,1295625,580487,963054,913048,12532,13946,3393,1870
2019년2분기,골목상권,자양로26길,광진구,구의1동,2288383,26478,10801,1571977,716401,1153582,1134796,12532,13946,8903,1898
2019년1분기,골목상권,자양로45길,광진구,중곡4동,1588233,20315,4330,1096405,491850,779389,808841,9736,10579,2058,2272
2019년2분기,골목상권,자양로45길,광진구,중곡4동,2001257,20315,3348,1366976,634274,956572,1044680,9736,10579,1858,1490
2019년1분기,골목상권,뚝섬로54길,광진구,자양2동,905118,20689,1566,639871,265256,462001,443112,10152,10537,705,861
2019년2분기,골목상권,뚝섬로54길,광진구,자양2동,1131883,20689,2293,780540,351366,569539,562343,10152,10537,1513,780
2019년1분기,골목상권,뚝섬로58길,광진구,자양2동,1099765,20031,4580,784818,314966,560168,539597,9779,10252,3064,1516
2019년2분기,골목상권,뚝섬로58길,광진구,자양2동,1338365,20031,3387,941394,396991,668567,669802,9779,10252,1986,1401
2019년1분기,골목상권,뚝섬로64길,광진구,자양2동,796559,10569,4295,575867,220702,422226,374332,5160,5409,2893,1402
2019년2분기,골목상권,뚝섬로64길,광진구,자양2동,937171,10569,3274,668926,268246,484183,452992,5160,5409,1776,1498
2019년1분기,골목상권,면목로17길,광진구,중곡3동,1378543,18960,2393,967207,411326,724152,654396,9554,9406,1489,904
2019년2분기,골목상권,면목로17길,광진구,중곡3동,1672942,18960,1939,1149412,523527,861016,811921,9554,9406,1408,531
2019년1분기,골목상권,아차산로40길,광진구,자양1동,2341032,22682,8136,1653790,687249,1202428,1138611,10969,11713,4004,4132
2019년2분기,골목상권,아차산로40길,광진구,자양1동,2763311,22682,3139,1938925,824388,1397880,1365430,10969,11713,1850,1289
2019년1분기,골목상권,아차산로51길,광진구,구의1동,1454426,15951,12146,1033811,420620,776823,677594,7506,8445,7228,4918
2019년2분기,골목상권,아차산로51길,광진구,구의1동,1764788,15951,13687,1252775,512011,926950,837833,7506,8445,10357,3330
2019년1분기,골목상권,아차산로55길,광진구,구의1동,1944615,19616,8966,1342897,601726,1010353,934256,9272,10344,5216,3750
2019년2분기,골목상권,아차산로55길,광진구,구의1동,2341639,19616,6735,1604890,736757,1194721,1146921,9272,10344,3479,3256
2019년1분기,골목상권,아차산로65길,광진구,구의3동,1841186,24029,4259,1310795,530394,881153,960037,11620,12409,2000,2259
2019년2분기,골목상권,아차산로65길,광진구,구의3동,2226561,24029,6030,1553940,672632,1045102,1181471,11620,12409,3776,2254
2019년1분기,골목상권,아차산로78길,광진구,광장동,664199,12956,4443,488197,175999,337117,327077,6231,6725,2376,2067
2019년2분기,골목상권,아차산로78길,광진구,광장동,826409,12956,10472,603132,223292,409651,416762,6231,6725,6194,4278
2019년1분기,골목상권,능동로19길,광진구,화양동,2475598,13816,5593,1727506,748093,1262816,1212782,6667,7149,2554,3039
2019년2분기,골목상권,능동로19길,광진구,화양동,3008116,13816,2152,2090478,917650,1523944,1484176,6667,7149,1356,796
2019년1분기,골목상권,능동로34길,광진구,능동,1829301,19799,8033,1317078,512229,928147,901154,9275,10524,3684,4349
2019년2분기,골목상권,능동로34길,광진구,능동,2322169,19799,5128,1653897,668264,1142965,1179202,9275,10524,3063,2065
2019년1분기,골목상권,능동로3길,광진구,자양4동,1410764,22114,1612,988848,421931,716759,694002,10748,11366,789,823
2019년2분기,골목상권,능동로3길,광진구,자양4동,1828178,22114,2145,1270230,557961,907970,920210,10748,11366,1690,455
2019년1분기,골목상권,능동로4길,광진구,자양3동,1411900,22402,1603,997469,414439,700888,711021,10859,11543,719,884
2019년2분기,골목상권,능동로4길,광진구,자양3동,1894020,22402,2386,1321348,572670,918860,975153,10859,11543,1761,625
2019년1분기,골목상권,동일로18길,광진구,자양4동,2676704,14235,9072,1877469,799234,1356182,1320519,7104,7131,5783,3289
2019년2분기,골목상권,동일로18길,광진구,자양4동,2890864,14235,5296,2002968,887900,1445890,1444969,7104,7131,3382,1914
2019년1분기,골목상권,동일로24길,광진구,화양동,3138531,13730,7166,2181115,957408,1641462,1497069,6574,7156,4501,2665
2019년2분기,골목상권,동일로24길,광진구,화양동,3618828,13730,3596,2476540,1142282,1851730,1767094,6574,7156,2307,1289
2019년1분기,골목상권,답십리로69길,동대문구,장안2동,885613,16686,4317,642197,243426,480176,405443,8424,8262,2181,2136
2019년2분기,골목상권,답십리로69길,동대문구,장안2동,1055549,16686,3199,753003,302554,558762,496790,8424,8262,1556,1643
2019년1분기,골목상권,답십리로72길,동대문구,장안1동,1570288,19893,4321,1099267,471015,834319,735971,9795,10098,2270,2051
2019년2분기,골목상권,답십리로72길,동대문구,장안1동,1920384,19893,5358,1324729,595668,1013241,907148,9795,10098,3024,2334
2019년1분기,골목상권,망우로18가길,동대문구,휘경2동,1019059,9239,4261,715224,303835,554128,464924,4736,4503,1925,2336
2019년2분기,골목상권,망우로18가길,동대문구,휘경2동,1209857,9239,1880,839544,370322,639707,570140,4736,4503,990,890
2019년1분기,골목상권,망우로18길,동대문구,휘경2동,1348405,11651,4680,948419,399986,709684,638714,5897,5754,2159,2521
2019년2분기,골목상권,망우로18길,동대문구,휘경2동,1613835,11651,3882,1122025,491813,828986,784837,5897,5754,1953,1929
2019년1분기,골목상권,망우로21길,동대문구,휘경1동,1791284,15620,2322,1250183,541093,902679,888600,7805,7815,1097,1225
2019년2분기,골목상권,망우로21길,동대문구,휘경1동,2102024,15620,3171,1447718,654321,1047660,1054358,7805,7815,1603,1568
2019년1분기,골목상권,무학로16길,동대문구,용신동,684429,14061,11118,527807,156635,382189,302247,6954,7107,7623,3495
2019년2분기,골목상권,무학로16길,동대문구,용신동,814340,14061,3110,618254,196083,449242,365102,6954,7107,2010,1100
2019년1분기,골목상권,자양로50길,광진구,구의2동,1121360,20109,2824,769502,351880,561389,559974,9707,10402,1318,1506
2019년2분기,골목상권,자양로50길,광진구,구의2동,1555705,20109,3213,1068084,487636,748587,807123,9707,10402,1920,1293
2019년1분기,골목상권,자양로53길,광진구,중곡4동,1762243,23558,2807,1221290,540981,859769,902475,11443,12115,1348,1459
2019년2분기,골목상권,자양로53길,광진구,중곡4동,2199558,23558,3112,1505726,693823,1053503,1146049,11443,12115,1951,1161
2019년1분기,골목상권,자양번영로3길,광진구,자양3동,1238195,18980,1786,882226,355970,616365,621833,9312,9668,798,988
2019년2분기,골목상권,자양번영로3길,광진구,자양3동,1550263,18980,2324,1077982,472285,754482,795776,9312,9668,1553,771
2019년1분기,골목상권,천호대로109길,광진구,중곡2동,2089146,23117,5742,1508124,581024,1086024,1003126,11058,12059,3224,2518
2019년2분기,골목상권,천호대로109길,광진구,중곡2동,2648106,23117,4550,1900174,747921,1351007,1297095,11058,12059,2707,1843
2019년1분기,골목상권,천호대로123길,광진구,중곡2동,1792761,24263,4838,1265479,527304,871436,921323,11576,12687,2376,2462
2019년2분기,골목상권,천호대로123길,광진구,중곡2동,2231959,24263,3898,1559835,672109,1067395,1164554,11576,12687,2175,1723
2019년1분기,골목상권,천호대로129길,광진구,구의2동,1767666,26977,3585,1211988,555705,870174,897493,13029,13948,1748,1837
2019년2분기,골목상권,천호대로129길,광진구,구의2동,2338750,26977,3629,1597630,741134,1116012,1222743,13029,13948,2259,1370
2019년1분기,골목상권,경희대로3길,동대문구,회기동,2227585,7949,4651,1675613,551963,1087428,1140147,3826,4123,1905,2746
2019년2분기,골목상권,경희대로3길,동대문구,회기동,2682424,7949,2199,2016257,666175,1277928,1404499,3826,4123,1212,987
2019년1분기,골목상권,경희대로4길,동대문구,회기동,3010009,10347,7141,2216835,793169,1461800,1548203,4953,5394,3071,4070
2019년2분기,골목상권,경희대로4길,동대문구,회기동,3607000,10347,2413,2654211,952800,1714376,1892630,4953,5394,802,1611
2019년1분기,골목상권,난계로30길,동대문구,용신동,1795672,8950,15058,1257983,537675,1003992,791675,4491,4459,7007,8051
2019년2분기,골목상권,난계로30길,동대문구,용신동,2151917,8950,10345,1497733,654186,1196292,955624,4491,4459,4859,5486
2019년1분기,골목상권,답십리로23길,동대문구,전농1동,1456173,18992,1192,1034368,421795,779306,676861,9451,9541,577,615
2019년2분기,골목상권,답십리로23길,동대문구,전농1동,1880170,18992,713,1324702,555479,1010887,869292,9451,9541,405,308
2019년1분기,골목상권,답십리로56길,동대문구,답십리2동,1274448,22875,2046,901927,372515,643875,630577,11206,11669,1042,1004
2019년2분기,골목상권,답십리로56길,동대문구,답십리2동,1553002,22875,1731,1081630,471382,771892,781111,11206,11669,1030,701
2019년1분기,골목상권,답십리로60길,동대문구,답십리2동,1076344,19365,3461,769521,306817,577721,498628,9683,9682,2098,1363
2019년2분기,골목상권,답십리로60길,동대문구,답십리2동,1261816,19365,2888,887293,374541,673852,587972,9683,9682,1591,1297
2019년1분기,골목상권,답십리로63길,동대문구,장안2동,1150660,13069,3256,822658,327993,597132,553535,6590,6479,1438,1818
2019년2분기,골목상권,답십리로63길,동대문구,장안2동,1349166,13069,4150,949663,399512,689165,660005,6590,6479,2144,2006
2019년1분기,골목상권,답십리로64길,동대문구,장안1동,1452013,20285,4598,1030889,421116,770402,681609,10208,10077,2433,2165
2019년2분기,골목상권,답십리로64길,동대문구,장안1동,1725993,20285,4055,1211701,514308,907852,818151,10208,10077,2069,1986
2019년1분기,골목상권,답십리로68길,동대문구,장안1동,1776427,18807,5672,1256048,520370,955628,820802,9527,9280,2942,2730
2019년2분기,골목상권,답십리로68길,동대문구,장안1동,2136055,18807,4974,1496378,639685,1137774,998282,9527,9280,2389,2585
2019년1분기,골목상권,서울시립대로4길,동대문구,전농1동,1657464,20649,2273,1156424,501029,848876,808585,10309,10340,1232,1041
2019년2분기,골목상권,서울시립대로4길,동대문구,전농1동,1978124,20649,1455,1353439,624683,978931,999193,10309,10340,946,509
2019년1분기,골목상권,약령시로17길,동대문구,제기동,1320428,13229,3310,924675,395738,733682,586737,6662,6567,1960,1350
2019년2분기,골목상권,약령시로17길,동대문구,제기동,1666450,13229,2220,1165839,500617,921525,744921,6662,6567,1414,806
2019년1분기,골목상권,왕산로32길,동대문구,용신동,1115986,8095,4345,821360,294629,578839,537150,4253,3842,2356,1989
2019년2분기,골목상권,왕산로32길,동대문구,용신동,1252969,8095,2531,916343,336633,642910,610056,4253,3842,1363,1168
2019년1분기,골목상권,장한로5길,동대문구,장안1동,1772108,15649,9893,1298912,473190,1003795,768316,8066,7583,5857,4036
2019년2분기,골목상권,장한로5길,동대문구,장안1동,2070585,15649,5840,1508315,562269,1164313,906279,8066,7583,3658,2182
2019년1분기,골목상권,장한로8길,동대문구,장안1동,1227505,11768,10101,908468,319041,716636,510879,6004,5764,6207,3894
2019년2분기,골목상권,장한로8길,동대문구,장안1동,1489680,11768,5218,1102761,386932,856850,632831,6004,5764,3301,1917
2019년1분기,골목상권,전농로29길,동대문구,전농1동,1899855,14738,3197,1426029,473825,967572,932273,7274,7464,1676,1521
2019년2분기,골목상권,전농로29길,동대문구,전농1동,2350723,14738,3125,1757570,593174,1226179,1124556,7274,7464,1723,1402
2019년1분기,골목상권,전농로3길,동대문구,답십리1동,1868100,20188,3199,1329999,538098,932359,935734,9860,10328,1446,1753
2019년2분기,골목상권,전농로3길,동대문구,답십리1동,2226727,20188,5358,1565029,661705,1092363,1134360,9860,10328,2290,3068
2019년1분기,골목상권,전농로4길,동대문구,답십리2동,1846213,18354,23971,1337608,508592,983307,862910,9132,9222,19834,4137
2019년2분기,골목상권,전농로4길,동대문구,답십리2동,2153380,18354,3945,1538158,615232,1135041,1018337,9132,9222,2695,1250
2019년1분기,골목상권,제기로21길,동대문구,청량리동,785943,13276,2569,559806,226137,422081,363869,6703,6573,1437,1132
2019년2분기,골목상권,제기로21길,동대문구,청량리동,982548,13276,2988,693765,288797,522657,459901,6703,6573,1831,1157
2019년1분기,골목상권,왕산로33길,동대문구,제기동,1580906,6843,2317,1119107,461791,864024,716875,3541,3302,1334,983
2019년2분기,골목상권,왕산로33길,동대문구,제기동,1933007,6843,1292,1368873,564134,1063899,869097,3541,3302,748,544
2019년1분기,골목상권,왕산로43길,동대문구,청량리동,1567585,18910,4248,1099468,468113,798365,769220,9582,9328,2262,1986
2019년2분기,골목상권,왕산로43길,동대문구,청량리동,2086375,18910,3510,1454906,631475,1072957,1013426,9582,9328,1924,1586
2019년1분기,골목상권,이문로42길,동대문구,이문2동,1262835,22145,1669,905778,357050,618858,643980,11010,11135,735,934
2019년2분기,골목상권,이문로42길,동대문구,이문2동,1406062,22145,1408,1011923,394150,683718,722345,11010,11135,830,578
2019년1분기,골목상권,장한로14길,동대문구,장안1동,711932,13868,4576,519135,192798,401331,310611,6947,6921,2686,1890
2019년2분기,골목상권,장한로14길,동대문구,장안1동,939572,13868,3323,680326,259256,520696,418881,6947,6921,2048,1275
2019년1분기,골목상권,장한로25길,동대문구,장안1동,1657607,14359,4491,1167777,489818,877373,780231,7250,7109,2146,2345
2019년2분기,골목상권,장한로25길,동대문구,장안1동,1979666,14359,3162,1378402,601271,1034239,945431,7250,7109,1385,1777
2019년1분기,골목상권,장한로26가길,동대문구,장안2동,1719940,19596,5253,1207634,512296,921645,798296,9751,9845,2648,2605
2019년2분기,골목상권,장한로26가길,동대문구,장안2동,2121633,19596,3858,1471437,650205,1128214,993426,9751,9845,1803,2055
2019년1분기,골목상권,장한로26길,동대문구,장안1동,1559461,17410,3575,1084574,474881,824327,735132,8545,8865,1555,2020
2019년2분기,골목상권,장한로26길,동대문구,장안1동,1883850,17410,4673,1290937,592927,984713,899142,8545,8865,2574,2099
2019년1분기,골목상권,장한로27가길,동대문구,장안2동,1369012,13601,4908,985646,383355,732298,636718,6925,6676,2084,2824
2019년2분기,골목상권,장한로27가길,동대문구,장안2동,1619413,13601,5769,1149540,469883,850563,768853,6925,6676,2830,2939
2019년1분기,골목상권,장한로27길,동대문구,장안2동,1596613,13481,4746,1131916,464686,847585,749034,6837,6644,2111,2635
2019년2분기,골목상권,장한로27길,동대문구,장안2동,1904404,13481,5193,1333844,570564,993258,911155,6837,6644,2598,2595
2019년1분기,골목상권,무학로45길,동대문구,용신동,1574964,8498,4590,1211486,363478,954657,620312,4623,3875,2493,2097
2019년2분기,골목상권,무학로45길,동대문구,용신동,2071282,8498,4256,1601096,470200,1225620,845660,4623,3875,2741,1515
2019년1분기,골목상권,사가정로13길,동대문구,전농2동,942850,17429,3283,704817,238032,436049,506801,8456,8973,1574,1709
2019년2분기,골목상권,사가정로13길,동대문구,전농2동,876923,17429,4543,655026,221926,403574,473354,8456,8973,2341,2202
2019년1분기,골목상권,사가정로23가길,동대문구,장안2동,827085,17608,3672,586922,240153,417940,409148,8564,9044,1950,1722
2019년2분기,골목상권,사가정로23가길,동대문구,장안2동,943233,17608,3149,654187,289064,473152,470088,8564,9044,1870,1279
2019년1분기,골목상권,사가정로2길,동대문구,답십리1동,1788895,17966,5175,1307717,481180,919148,869738,8822,9144,2731,2444
2019년2분기,골목상권,사가정로2길,동대문구,답십리1동,2037110,17966,6370,1473243,563857,1026517,1010579,8822,9144,2982,3388
2019년1분기,골목상권,서울시립대로16길,동대문구,전농1동,2022053,16793,1728,1484486,537561,1014181,1007857,8337,8456,798,930
2019년2분기,골목상권,서울시립대로16길,동대문구,전농1동,2450453,16793,1454,1791948,658530,1254776,1195690,8337,8456,861,593
2019년1분기,골목상권,서울시립대로29길,동대문구,전농1동,1899361,15105,3731,1371352,528008,977183,922161,7707,7398,1932,1799
2019년2분기,골목상권,서울시립대로29길,동대문구,전농1동,2426072,15105,3126,1756446,669643,1267680,1158398,7707,7398,1608,1518
2019년1분기,골목상권,겸재로29길,중랑구,면목본동,1730442,20758,3936,1237085,493357,905699,824738,10322,10436,2105,1831
2019년2분기,골목상권,겸재로29길,중랑구,면목본동,2065503,20758,2791,1464641,600883,1051019,1014492,10322,10436,1633,1158
2019년1분기,골목상권,겸재로36길,중랑구,면목본동,1745321,23761,2011,1239564,505764,896612,848711,11903,11858,981,1030
2019년2분기,골목상권,겸재로36길,중랑구,면목본동,2099730,23761,2133,1476070,623669,1042655,1057073,11903,11858,1305,828
2019년1분기,골목상권,겸재로54길,중랑구,면목본동,2349291,28921,2578,1655414,693887,1219904,1129398,14432,14489,1140,1438
2019년2분기,골목상권,겸재로54길,중랑구,면목본동,2847715,28921,1921,1986945,860776,1439364,1408349,14432,14489,1068,853
2019년1분기,골목상권,공릉로12가길,중랑구,묵1동,840525,14911,1893,594085,246443,439392,401137,7374,7537,785,1108
2019년2분기,골목상권,공릉로12가길,중랑구,묵1동,997092,14911,1642,693555,303539,495238,501859,7374,7537,777,865
2019년1분기,골목상권,공릉로2길,중랑구,묵1동,1539750,20852,2349,1077064,462696,762118,777636,10191,10661,1119,1230
2019년2분기,골목상권,공릉로2길,중랑구,묵1동,1825084,20852,2013,1256107,568964,884813,940281,10191,10661,1097,916
2019년1분기,골목상권,답십리로75길,중랑구,면목4동,1075824,15741,1786,760481,315349,553308,522526,8003,7738,1050,736
2019년2분기,골목상권,답십리로75길,중랑구,면목4동,1311556,15741,1513,902900,408645,661011,650538,8003,7738,1050,463
2019년1분기,골목상권,제기로5길,동대문구,제기동,1331086,8323,4836,1021720,309373,714887,616199,4362,3961,2844,1992
2019년2분기,골목상권,제기로5길,동대문구,제기동,1935133,8323,1069,1495484,439654,1017767,917368,4362,3961,648,421
2019년1분기,골목상권,천장산로7길,동대문구,이문1동,930317,7031,7698,733648,196667,461538,468779,3601,3430,3577,4121
2019년2분기,골목상권,천장산로7길,동대문구,이문1동,1378057,7031,1468,1137742,240320,648665,729392,3601,3430,893,575
2019년1분기,골목상권,천호대로12길,동대문구,용신동,927675,10913,13309,695717,231967,503989,423684,5389,5524,6843,6466
2019년2분기,골목상권,천호대로12길,동대문구,용신동,1094349,10913,8882,814499,279851,586138,508217,5389,5524,4148,4734
2019년1분기,골목상권,천호대로17길,동대문구,용신동,1756561,15990,8745,1322226,434352,939944,816618,7925,8065,5262,3483
2019년2분기,골목상권,천호대로17길,동대문구,용신동,2274221,15990,8220,1715328,558898,1179699,1094526,7925,8065,4956,3264
2019년1분기,골목상권,천호대로45길,동대문구,용신동,1336669,10539,4559,963780,372897,698088,638586,5484,5055,2481,2078
2019년2분기,골목상권,천호대로45길,동대문구,용신동,1436338,10539,2803,1018598,417746,740887,695447,5484,5055,1586,1217
2019년1분기,골목상권,천호대로77길,동대문구,장안1동,1339840,10299,14144,996479,343359,773305,566536,5355,4944,8768,5376
2019년2분기,골목상권,천호대로77길,동대문구,장안1동,1505877,10299,7559,1111466,394413,861965,643915,5355,4944,4798,2761
2019년1분기,골목상권,천호대로97길,동대문구,장안1동,689366,9727,5759,504860,184517,401579,287798,4968,4759,3635,2124
2019년2분기,골목상권,천호대로97길,동대문구,장안1동,868633,9727,2780,636489,232158,500055,368577,4968,4759,1714,1066
2019년1분기,골목상권,한천로14길,동대문구,장안1동,1697230,21353,8920,1228835,468393,943369,753865,10851,10502,5286,3634
2019년2분기,골목상권,한천로14길,동대문구,장안1동,2027129,21353,5561,1457225,569905,1117709,909423,10851,10502,3333,2228
2019년1분기,골목상권,한천로33길,동대문구,전농2동,703455,15821,1948,499032,204412,350238,353224,7797,8024,868,1080
2019년2분기,골목상권,한천로33길,동대문구,전농2동,810502,15821,4276,563283,247230,398805,411702,7797,8024,2324,1952
2019년1분기,골목상권,한천로40길,동대문구,장안2동,1015676,14717,3836,727129,288546,526990,488697,7314,7403,2036,1800
2019년2분기,골목상권,한천로40길,동대문구,장안2동,1164741,14717,3982,818404,346354,597763,566985,7314,7403,2435,1547
2019년1분기,골목상권,한천로46길,동대문구,장안2동,463090,15591,2993,326554,136532,234096,228999,7482,8109,1685,1308
2019년2분기,골목상권,한천로46길,동대문구,장안2동,546122,15591,3109,373334,172791,275364,270757,7482,8109,1933,1176
2019년1분기,골목상권,휘경로14길,동대문구,휘경1동,1896568,15360,1532,1367846,528734,999369,897206,7713,7647,758,774
2019년2분기,골목상권,휘경로14길,동대문구,휘경1동,2311240,15360,1552,1666835,644424,1181127,1130111,7713,7647,892,660
2019년1분기,골목상권,휘경로23길,동대문구,이문1동,1166486,16571,576,821837,344652,611445,555049,8276,8295,254,322
2019년2분기,골목상권,휘경로23길,동대문구,이문1동,1325964,16571,754,920277,405696,684977,640987,8276,8295,444,310
2019년1분기,골목상권,휘경로2길,동대문구,이문1동,1927977,13079,2451,1406105,521874,970677,957302,6562,6517,1315,1136
2019년2분기,골목상권,휘경로2길,동대문구,이문1동,2465128,13079,3064,1833236,631901,1211828,1253305,6562,6517,1255,1809
2019년1분기,골목상권,휘경로3길,동대문구,이문1동,2284172,20710,2621,1689820,594345,1173274,1110910,10391,10319,1375,1246
2019년2분기,골목상권,휘경로3길,동대문구,이문1동,2769068,20710,1817,2091369,677714,1374487,1394579,10391,10319,1078,739
2019년1분기,골목상권,동일로139길,중랑구,중화2동,1180000,15066,2631,836818,343178,615953,564038,7630,7436,1365,1266
2019년2분기,골목상권,동일로139길,중랑구,중화2동,1452310,15066,1855,1001966,450343,748108,704197,7630,7436,1299,556
2019년1분기,골목상권,동일로140길,중랑구,중화1동,1462923,16965,3178,1047292,415632,744672,718244,8490,8475,1565,1613
2019년2분기,골목상권,동일로140길,중랑구,중화1동,1763032,16965,2467,1243693,519349,879595,883437,8490,8475,1583,884
2019년1분기,골목상권,동일로149길,중랑구,묵2동,923649,14898,2168,650759,272880,479357,444291,7461,7437,1179,989
2019년2분기,골목상권,동일로149길,중랑구,묵2동,1158848,14898,1701,789020,369817,586672,572186,7461,7437,1170,531
2019년1분기,골목상권,면목로55길,중랑구,면목본동,1309903,18156,2363,928583,381328,681646,628266,9107,9049,1189,1174
2019년2분기,골목상권,면목로55길,중랑구,면목본동,1552708,18156,2509,1084312,468402,781225,771479,9107,9049,1555,954
2019년1분기,골목상권,면목로56길,중랑구,면목본동,1654456,22193,2652,1160895,493572,867105,787367,11034,11159,1306,1346
2019년2분기,골목상권,면목로56길,중랑구,면목본동,1967812,22193,2693,1364603,603225,996019,971791,11034,11159,1652,1041
2019년1분기,골목상권,면목로78길,중랑구,면목본동,2211900,24617,4247,1574319,637576,1141124,1070762,12223,12394,2191,2056
2019년2분기,골목상권,면목로78길,중랑구,면목본동,2692420,24617,2879,1899317,793115,1352367,1340060,12223,12394,1669,1210
2019년1분기,골목상권,봉우재로33길,중랑구,상봉2동,2317993,15992,4722,1601517,716476,1197193,1120796,7868,8124,2691,2031
2019년2분기,골목상권,봉우재로33길,중랑구,상봉2동,2918848,15992,3268,2003918,914946,1475507,1443337,7868,8124,2004,1264
2019년1분기,골목상권,봉화산로30길,중랑구,중화1동,1417392,21917,2337,999800,417596,704390,713003,10837,11080,1157,1180
2019년2분기,골목상권,봉화산로30길,중랑구,중화1동,1700023,21917,1896,1185591,514414,833055,866965,10837,11080,1116,780
2019년1분기,골목상권,봉화산로4길,중랑구,중화2동,1457134,20783,1970,1018400,438737,762365,694758,10701,10082,944,1026
2019년2분기,골목상권,봉화산로4길,중랑구,중화2동,1789622,20783,1082,1232514,557099,930583,859035,10701,10082,589,493
2019년1분기,골목상권,동일로157길,중랑구,묵2동,2306004,27934,3871,1611070,694933,1156428,1149586,13774,14160,1954,1917
2019년2분기,골목상권,동일로157길,중랑구,묵2동,2746724,27934,3145,1876095,870623,1345688,1401044,13774,14160,1925,1220
2019년1분기,골목상권,동일로163길,중랑구,묵2동,1381725,17981,2063,965671,416051,691825,689909,8867,9114,1013,1050
2019년2분기,골목상권,동일로163길,중랑구,묵2동,1646758,17981,1302,1124954,521801,810358,836414,8867,9114,722,580
2019년1분기,골목상권,망우로68길,중랑구,망우본동,1397193,18144,3300,961115,436075,694008,703181,9308,8836,1586,1714
2019년2분기,골목상권,망우로68길,중랑구,망우본동,1655708,18144,2001,1126670,529042,809014,846685,9308,8836,1107,894
2019년1분기,골목상권,망우로73길,중랑구,망우본동,687977,12478,2220,475941,212027,323636,364339,6376,6102,1176,1044
2019년2분기,골목상권,망우로73길,중랑구,망우본동,832497,12478,1797,569392,263101,387012,445478,6376,6102,1089,708
2019년1분기,골목상권,면목로21길,중랑구,면목4동,1121907,14924,1832,792060,329843,587595,534323,7469,7455,1100,732
2019년2분기,골목상권,면목로21길,중랑구,면목4동,1359806,14924,1517,935287,424522,695329,664470,7469,7455,1017,500
2019년1분기,골목상권,면목로33길,중랑구,면목4동,1276471,19630,1943,901494,374985,650448,626027,9779,9851,1136,807
2019년2분기,골목상권,면목로33길,중랑구,면목4동,1539798,19630,1674,1064400,475388,771824,767968,9779,9851,1120,554
2019년1분기,골목상권,면목로45길,중랑구,면목3.8동,2318522,15592,2737,1634453,684077,1213817,1104709,7793,7799,1300,1437
2019년2분기,골목상권,면목로45길,중랑구,면목3.8동,2684728,15592,3040,1878499,806233,1363612,1321112,7793,7799,1771,1269
2019년1분기,골목상권,면목로48길,중랑구,면목3.8동,1851771,19841,2824,1296882,554888,987459,864319,9950,9891,1327,1497
2019년2분기,골목상권,면목로48길,중랑구,면목3.8동,2139915,19841,3491,1482886,657039,1102985,1036928,9950,9891,2043,1448
2019년1분기,골목상권,면목로49길,중랑구,면목3.8동,2163540,17219,2816,1528789,634755,1139201,1024350,8665,8554,1307,1509
2019년2분기,골목상권,면목로49길,중랑구,면목3.8동,2523585,17219,3501,1765840,757744,1288659,1234918,8665,8554,2060,1441
2019년1분기,골목상권,동일로100길,중랑구,면목2동,1472139,24431,4830,1058662,413494,763658,708479,12370,12061,2650,2180
2019년2분기,골목상권,동일로100길,중랑구,면목2동,1749668,24431,3344,1242199,507489,884368,865309,12370,12061,2151,1193
2019년1분기,골목상권,동일로101길,중랑구,면목2동,1505637,21430,2256,1074150,431487,770924,734721,10736,10694,1082,1174
2019년2분기,골목상권,동일로101길,중랑구,면목2동,1822502,21430,1396,1278980,543522,919994,902510,10736,10694,804,592
2019년1분기,골목상권,동일로112길,중랑구,상봉2동,2136729,24427,5932,1517588,619150,1107913,1028819,12171,12256,3120,2812
2019년2분기,골목상권,동일로112길,중랑구,상봉2동,2606390,24427,4467,1831331,775079,1318106,1288282,12171,12256,2719,1748
2019년1분기,골목상권,동일로123길,중랑구,중화2동,1912955,23991,3182,1352719,560243,974213,938732,12178,11813,1650,1532
2019년2분기,골목상권,동일로123길,중랑구,중화2동,2307059,23991,2503,1612159,694906,1165225,1141835,12178,11813,1568,935
2019년1분기,골목상권,동일로130길,중랑구,중화1동,1764118,22903,2110,1257151,506976,879543,884571,11422,11481,849,1261
2019년2분기,골목상권,동일로130길,중랑구,중화1동,2101540,22903,1465,1482873,618663,1040163,1061377,11422,11481,783,682
2019년1분기,골목상권,동일로139가길,중랑구,중화2동,1570413,19354,3257,1113752,456657,810279,760124,9724,9630,1692,1565
2019년2분기,골목상권,동일로139가길,중랑구,중화2동,1907176,19354,2308,1322945,584236,967622,939559,9724,9630,1527,781
2019년1분기,골목상권,돌곶이로8길,성북구,석관동,1081554,14211,1521,773286,308289,564148,517409,7115,7096,858,663
2019년2분기,골목상권,돌곶이로8길,성북구,석관동,1429358,14211,1528,1000989,428377,716508,712840,7115,7096,1012,516
2019년1분기,골목상권,동소문로13길,성북구,동선동,3235775,21024,6156,2333409,902373,1517236,1718540,9757,11267,2666,3490
2019년2분기,골목상권,동소문로13길,성북구,동선동,3778254,21024,14085,2707685,1070588,1749284,2028975,9757,11267,6702,7383
2019년1분기,골목상권,동소문로15길,성북구,동선동,3015992,13002,5509,2136169,879832,1402142,1613851,5866,7136,2336,3173
2019년2분기,골목상권,동소문로15길,성북구,동선동,3511089,13002,11663,2484234,1026858,1602800,1908293,5866,7136,5691,5972
2019년1분기,골목상권,동소문로26가길,성북구,동선동,3474719,13401,7953,2454207,1020518,1547592,1927130,5879,7522,3130,4823
2019년2분기,골목상권,동소문로26가길,성북구,동선동,4082900,13401,3875,2887434,1195448,1762600,2320299,5879,7522,1797,2078
2019년1분기,골목상권,동소문로2길,성북구,삼선동,1633170,9269,2298,1181916,451272,772513,860662,4418,4851,1072,1226
2019년2분기,골목상권,동소문로2길,성북구,삼선동,1984896,9269,2541,1419987,564921,935522,1049374,4418,4851,1210,1331
2019년1분기,골목상권,동소문로6길,성북구,삼선동,1373569,8220,2376,987484,386104,646938,726636,3929,4291,945,1431
2019년2분기,골목상권,동소문로6길,성북구,삼선동,1712507,8220,2119,1216865,495643,804058,908444,3929,4291,1042,1077
2019년1분기,골목상권,봉화산로56길,중랑구,신내1동,1709540,30609,6060,1215104,494441,853406,856138,14994,15615,3035,3025
2019년2분기,골목상권,봉화산로56길,중랑구,신내1동,2006769,30609,5853,1402501,604279,979382,1027384,14994,15615,3579,2274
2019년1분기,골목상권,사가정로42길,중랑구,면목7동,1649376,18089,1196,1163904,485476,840071,809310,9086,9003,628,568
2019년2분기,골목상권,사가정로42길,중랑구,면목7동,1931880,18089,1099,1347508,584361,960623,971256,9086,9003,663,436
2019년1분기,골목상권,사가정로54길,중랑구,면목7동,2234820,20629,2371,1565138,669674,1162844,1071980,10232,10397,1300,1071
2019년2분기,골목상권,사가정로54길,중랑구,면목7동,2566963,20629,3062,1785248,781714,1296086,1270879,10232,10397,1914,1148
2019년1분기,골목상권,신내로7가길,중랑구,상봉1동,1341579,25677,2546,945482,396103,674013,667568,12664,13013,1005,1541
2019년2분기,골목상권,신내로7가길,중랑구,상봉1동,1605842,25677,2548,1107646,498202,794564,811271,12664,13013,1590,958
2019년1분기,골목상권,용마산로100길,중랑구,망우3동,653482,19730,1971,471995,181495,339724,313755,10043,9687,998,973
2019년2분기,골목상권,용마산로100길,중랑구,망우3동,796520,19730,1301,563690,232841,406233,390294,10043,9687,752,549
2019년1분기,골목상권,용마산로112길,중랑구,망우본동,945695,13302,1987,643168,302532,459778,485912,6841,6461,1051,936
2019년2분기,골목상권,용마산로112길,중랑구,망우본동,1155873,13302,1335,776180,379694,556281,599587,6841,6461,826,509
2019년1분기,골목상권,용마산로118길,중랑구,망우본동,1144130,18472,3028,789626,354506,554137,589991,9420,9052,1572,1456
2019년2분기,골목상권,용마산로118길,중랑구,망우본동,1412292,18472,2145,962864,449433,673221,739070,9420,9052,1347,798
2019년1분기,골목상권,용마산로94길,중랑구,면목3.8동,774254,16213,2120,561712,212551,418845,355406,8268,7945,1216,904
2019년2분기,골목상권,용마산로94길,중랑구,면목3.8동,993323,16213,1288,714836,278493,529895,463444,8268,7945,830,458
2019년1분기,골목상권,중랑천로10길,중랑구,면목2동,1604363,16223,4843,1125878,478483,821647,782725,8105,8118,3012,1831
2019년2분기,골목상권,중랑천로10길,중랑구,면목2동,1952103,16223,3351,1353573,598528,982149,969950,8105,8118,2262,1089
2019년1분기,골목상권,길음로7길,성북구,길음1동,1101759,13741,2018,782968,318796,533733,568027,6483,7258,744,1274
2019년2분기,골목상권,길음로7길,성북구,길음1동,1317045,13741,2191,920710,396326,626771,690277,6483,7258,707,1484
2019년1분기,골목상권,돌곶이로14길,성북구,석관동,1305250,13791,1731,939984,365289,668217,637039,6962,6829,991,740
2019년2분기,골목상권,돌곶이로14길,성북구,석관동,1621470,13791,1431,1147874,473607,804901,816562,6962,6829,964,467
2019년1분기,골목상권,돌곶이로22길,성북구,석관동,1419368,13471,3157,1030188,389200,713079,706294,6780,6691,1791,1366
2019년2분기,골목상권,돌곶이로22길,성북구,석관동,1698383,13471,2717,1224127,474273,833961,864425,6780,6691,1807,910
2019년1분기,골목상권,돌곶이로27길,성북구,장위2동,1263826,13983,2485,915076,348763,619694,644126,6921,7062,1178,1307
2019년2분기,골목상권,돌곶이로27길,성북구,장위2동,1520902,13983,1369,1092497,428408,747923,772989,6921,7062,777,592
2019년1분기,골목상권,돌곶이로28길,성북구,장위2동,1049268,11058,3461,757952,291334,532804,516463,5611,5447,2193,1268
2019년2분기,골목상권,돌곶이로28길,성북구,장위2동,1280040,11058,2768,922563,357483,647580,632469,5611,5447,1850,918
2019년1분기,골목상권,돌곶이로41길,성북구,장위1동,720777,12673,770,494883,225893,370651,350130,6247,6426,354,416
2019년2분기,골목상권,돌곶이로41길,성북구,장위1동,1017859,12673,592,681192,336672,509034,508825,6247,6426,288,304
2019년1분기,골목상권,삼선교로10다길,성북구,삼선동,1755412,13313,1644,1318398,437024,840610,914799,6515,6798,761,883
2019년2분기,골목상권,삼선교로10다길,성북구,삼선동,2335815,13313,1342,1761097,574712,1124571,1211245,6515,6798,700,642
2019년1분기,골목상권,삼선교로16가길,성북구,삼선동,1570674,15652,1692,1188184,382502,759343,811328,7646,8006,776,916
2019년2분기,골목상권,삼선교로16가길,성북구,삼선동,2112588,15652,2478,1606608,505982,1029089,1083499,7646,8006,1648,830
2019년1분기,골목상권,삼양로8길,성북구,길음2동,1448210,18061,3190,1008578,439635,676901,771318,8738,9323,1134,2056
2019년2분기,골목상권,삼양로8길,성북구,길음2동,1958921,18061,1921,1344197,614720,894085,1064837,8738,9323,946,975
2019년1분기,골목상권,개운사길,성북구,안암동,1471959,3106,8349,1148049,323919,830147,641813,1620,1486,4109,4240
2019년2분기,골목상권,개운사길,성북구,안암동,1968630,3106,2717,1553451,415179,1094338,874293,1620,1486,1424,1293
2019년1분기,골목상권,인촌로24길,성북구,안암동,2398257,8215,9372,1848331,549936,1419766,978484,4330,3885,4693,4679
2019년2분기,골목상권,인촌로24길,성북구,안암동,3214809,8215,4488,2508434,706377,1875031,1339776,4330,3885,2659,1829
2019년1분기,골목상권,인촌로5길,성북구,안암동,2401714,10472,9127,1706066,695668,1040352,1361366,4735,5737,4123,5004
2019년2분기,골목상권,인촌로5길,성북구,안암동,2912664,10472,3436,2061098,851565,1222493,1690163,4735,5737,1918,1518
2019년1분기,골목상권,인촌로6길,성북구,보문동,1356144,14396,3607,998366,357771,711614,644527,7158,7238,2015,1592
2019년2분기,골목상권,인촌로6길,성북구,보문동,1617568,14396,7173,1180241,437330,851269,766299,7158,7238,5303,1870
2019년1분기,골목상권,장월로1길,성북구,월곡2동,1334386,13340,4477,972304,362080,623221,711164,6432,6908,2498,1979
2019년2분기,골목상권,장월로1길,성북구,월곡2동,1579323,13340,3804,1151394,427945,706829,872497,6432,6908,2328,1476
2019년1분기,골목상권,장위로50길,성북구,장위3동,662751,9758,3081,483134,179625,358345,304399,5078,4680,1958,1123
2019년2분기,골목상권,장위로50길,성북구,장위3동,860814,9758,2731,627744,233079,485432,375389,5078,4680,1782,949
2019년1분기,골목상권,성북로8길,성북구,성북동,856999,12681,2892,618742,238266,390925,466078,6007,6674,1262,1630
2019년2분기,골목상권,성북로8길,성북구,성북동,1070935,12681,3021,759415,311524,498138,572795,6007,6674,1593,1428
2019년1분기,골목상권,솔샘로6길,성북구,정릉3동,803812,12778,1472,560560,243251,437168,366646,6431,6347,827,645
2019년2분기,골목상권,솔샘로6길,성북구,정릉3동,985148,12778,1078,674821,310335,532485,452651,6431,6347,717,361
2019년1분기,골목상권,아리랑로4길,성북구,동선동,3199062,18425,3837,2262683,936381,1452818,1746243,8283,10142,1662,2175
2019년2분기,골목상권,아리랑로4길,성북구,동선동,3758739,18425,2556,2664628,1094095,1661749,2096989,8283,10142,1201,1355
2019년1분기,골목상권,안암로5길,성북구,안암동,1594493,15613,4496,1199901,394585,872148,722346,8071,7542,2418,2078
2019년2분기,골목상권,안암로5길,성북구,안암동,1942794,15613,4333,1459052,483752,1057358,885437,8071,7542,2673,1660
2019년1분기,골목상권,오패산로19길,성북구,월곡1동,1710792,14488,3311,1190697,520097,814476,896324,7130,7358,1481,1830
2019년2분기,골목상권,오패산로19길,성북구,월곡1동,2192927,14488,1952,1508936,684008,1008908,1184022,7130,7358,995,957
2019년1분기,골목상권,오패산로3길,성북구,월곡1동,1559834,21695,2879,1095929,463911,755389,804455,10679,11016,1453,1426
2019년2분기,골목상권,오패산로3길,성북구,월곡1동,1924286,21695,2984,1336688,587607,910317,1013968,10679,11016,1819,1165
2019년1분기,골목상권,오패산로4길,성북구,월곡2동,1971134,22025,5981,1409147,561992,913140,1058001,10619,11406,3349,2632
2019년2분기,골목상권,오패산로4길,성북구,월곡2동,2357431,22025,4166,1689756,667676,1040471,1316954,10619,11406,2598,1568
2019년1분기,골목상권,인촌로17가길,성북구,안암동,1057947,9795,5131,793442,264509,497312,560640,4716,5079,1988,3143
2019년2분기,골목상권,인촌로17가길,성북구,안암동,1349692,9795,2036,1005664,344022,623688,726004,4716,5079,1022,1014
2019년1분기,골목상권,인촌로1길,성북구,보문동,2690326,15430,6202,1918248,772092,1230073,1460250,7208,8222,3133,3069
2019년2분기,골목상권,인촌로1길,성북구,보문동,3145211,15430,3365,2222693,922522,1396946,1748268,7208,8222,2010,1355
2019년1분기,골목상권,보국문로16길,성북구,정릉4동,852864,22931,2611,608063,244798,447106,405754,11292,11639,1421,1190
2019년2분기,골목상권,보국문로16길,성북구,정릉4동,1114118,22931,1401,786917,327198,569396,544718,11292,11639,832,569
2019년1분기,골목상권,보문로13길,성북구,보문동,1399950,18194,4013,1027079,372860,727992,671956,9028,9166,2146,1867
2019년2분기,골목상권,보문로13길,성북구,보문동,1709402,18194,6567,1246686,462724,898688,810714,9028,9166,4836,1731
2019년1분기,골목상권,보문로26길,성북구,안암동,1584103,12252,6229,1171722,412392,739395,844712,5846,6406,2500,3729
2019년2분기,골목상권,보문로26길,성북구,안암동,1915082,12252,2426,1408581,506502,872208,1042873,5846,6406,1168,1258
2019년1분기,골목상권,보문로31길,성북구,삼선동,2225390,15959,6180,1611398,614007,1038548,1186844,7399,8560,3087,3093
2019년2분기,골목상권,보문로31길,성북구,삼선동,2613209,15959,5246,1871690,741526,1190234,1422980,7399,8560,2902,2344
2019년1분기,골목상권,보문로32길,성북구,동선동,3351161,9477,9280,2349712,1001467,1450656,1900501,4033,5444,4213,5067
2019년2분기,골목상권,보문로32길,성북구,동선동,3966252,9477,3531,2784832,1181418,1652511,2313739,4033,5444,1961,1570
2019년1분기,골목상권,삼선교로10길,성북구,삼선동,2093629,12767,1906,1536806,556838,1009690,1083937,6291,6476,749,1157
2019년2분기,골목상권,삼선교로10길,성북구,삼선동,2632679,12767,1627,1927399,705286,1268892,1363783,6291,6476,720,907
2019년1분기,골목상권,강서로45길,강서구,화곡3동,1062472,15649,2116,770193,292283,503729,558739,7568,8081,730,1386
2019년2분기,골목상권,강서로45길,강서구,화곡3동,1217205,15649,5297,865485,351725,537802,679413,7568,8081,3226,2071
2019년1분기,골목상권,강서로45다길,강서구,화곡3동,1416968,25521,2508,1002302,414670,679662,737302,12414,13107,978,1530
2019년2분기,골목상권,강서로45다길,강서구,화곡3동,1639895,25521,5855,1138906,500985,743560,896344,12414,13107,3622,2233
2019년1분기,골목상권,강서로47길,강서구,발산1동,1073433,24675,3332,800447,273008,484541,588897,11688,12987,1134,2198
2019년2분기,골목상권,강서로47길,강서구,발산1동,1411839,24675,1897,1018720,393143,623648,788208,11688,12987,832,1065
2019년1분기,골목상권,화곡로59길,강서구,화곡6동,1521187,12267,14558,1067207,453984,816189,705001,5943,6324,8259,6299
2019년2분기,골목상권,화곡로59길,강서구,화곡6동,1717507,12267,13146,1194249,523265,907071,810447,5943,6324,7810,5336
2019년1분기,골목상권,화곡로64길,강서구,등촌1동,1586631,17981,35534,1129053,457580,832647,753989,8500,9481,15198,20336
2019년2분기,골목상권,화곡로64길,강서구,등촌1동,1781142,17981,14195,1261074,520071,921589,859556,8500,9481,8485,5710
2019년1분기,골목상권,개봉로11길,구로구,개봉3동,1102622,23452,5057,767258,335359,545726,556894,11528,11924,2646,2411
2019년2분기,골목상권,개봉로11길,구로구,개봉3동,1235886,23452,2920,845368,390521,596317,639565,11528,11924,1316,1604
2019년1분기,골목상권,선유서로24길,영등포구,양평1동,1143566,12398,21865,899722,243852,644268,499298,6169,6229,12921,8944
2019년2분기,골목상권,선유서로24길,영등포구,양평1동,1331000,12398,22479,1036819,294180,743682,587319,6169,6229,11969,10510
2019년1분기,골목상권,선유서로25길,영등포구,양평1동,681127,13829,8231,523908,157226,381268,299860,6891,6938,5170,3061
2019년2분기,골목상권,선유서로25길,영등포구,양평1동,794613,13829,5355,600355,194255,436157,358458,6891,6938,3999,1356
2019년1분기,골목상권,선유서로28길,영등포구,양평1동,968891,11147,13989,755944,212965,550813,418078,5594,5553,7829,6160
2019년2분기,골목상권,선유서로28길,영등포구,양평1동,1129114,11147,8413,871600,257520,637216,491897,5594,5553,5175,3238
2019년1분기,골목상권,남부순환로58길,양천구,신월3동,539639,16575,1624,380347,159292,283275,256365,8642,7933,722,902
2019년2분기,골목상권,남부순환로58길,양천구,신월3동,660569,16575,1566,457412,203167,331110,329463,8642,7933,819,747
2019년1분기,골목상권,남부순환로70길,양천구,신월7동,605915,19648,3324,429079,176847,336707,269205,9706,9942,2288,1036
2019년2분기,골목상권,남부순환로70길,양천구,신월7동,764801,19648,3321,526211,238606,412859,351949,9706,9942,2494,827
2019년1분기,골목상권,남부순환로79길,양천구,신월6동,808951,12853,2667,600291,208659,455831,353106,6358,6495,1501,1166
2019년2분기,골목상권,남부순환로79길,양천구,신월6동,939820,12853,1921,680347,259479,522410,417416,6358,6495,1158,763
2019년1분기,골목상권,강서로47라길,강서구,발산1동,1092911,19653,3113,810578,282349,503508,589407,9304,10349,1099,2014
2019년2분기,골목상권,강서로47라길,강서구,발산1동,1352115,19653,1832,965953,386178,592892,759241,9304,10349,854,978
2019년1분기,골목상권,강서로5가길,강서구,화곡1동,3927997,21596,2721,2794372,1133644,2035393,1892606,10556,11040,1393,1328
2019년2분기,골목상권,강서로5가길,강서구,화곡1동,4369699,21596,2161,3072997,1296682,2189168,2180532,10556,11040,1284,877
2019년1분기,골목상권,강서로5나길,강서구,화곡1동,2379898,23184,2865,1633264,746643,1261737,1118154,11636,11548,1760,1105
2019년2분기,골목상권,강서로5나길,강서구,화곡1동,2745297,23184,2296,1865078,880219,1416511,1328789,11636,11548,1512,784
2019년1분기,골목상권,개봉로17길,구로구,개봉2동,834494,25143,1249,575276,259206,413954,420542,12365,12778,451,798
2019년2분기,골목상권,개봉로17길,구로구,개봉2동,949601,25143,4544,643307,306296,453849,495750,12365,12778,2383,2161
2019년1분기,골목상권,개봉로17다길,구로구,개봉2동,964325,28695,2184,665916,298399,481553,482778,14098,14597,978,1206
2019년2분기,골목상권,개봉로17다길,구로구,개봉2동,1096619,28695,5328,743503,353118,530810,565812,14098,14597,2960,2368
2019년1분기,골목상권,개봉로1길,구로구,개봉3동,637782,13457,877,447911,189875,317798,319983,6662,6795,452,425
2019년2분기,골목상권,개봉로1길,구로구,개봉3동,722796,13457,1125,495746,227049,358165,364629,6662,6795,674,451
2019년1분기,골목상권,신길로17길,영등포구,신길5동,1004744,14728,1730,699467,305285,520863,483870,7251,7477,767,963
2019년2분기,골목상권,신길로17길,영등포구,신길5동,1277335,14728,2354,883314,394028,640427,636898,7251,7477,1284,1070
2019년1분기,골목상권,신길로39길,영등포구,신길3동,1694493,15845,2369,1195178,499325,867758,826730,7963,7882,1045,1324
2019년2분기,골목상권,신길로39길,영등포구,신길3동,1996674,15845,1789,1388055,608626,995853,1000819,7963,7882,1010,779
2019년1분기,골목상권,신길로42가길,영등포구,신길1동,1980694,19822,2267,1409172,571536,1034007,946700,9947,9875,968,1299
2019년2분기,골목상권,신길로42가길,영등포구,신길1동,2297758,19822,2756,1609806,687963,1200108,1097646,9947,9875,1550,1206
2019년1분기,골목상권,남부순환로88길,양천구,신정3동,321660,12743,3013,223370,98287,164901,156756,6215,6528,2188,825
2019년2분기,골목상권,남부순환로88길,양천구,신정3동,423108,12743,2340,285866,137237,210103,213004,6215,6528,1566,774
2019년1분기,골목상권,목동남로4길,양천구,신정7동,525943,16289,1098,363341,162604,265372,260568,7970,8319,547,551
2019년2분기,골목상권,목동남로4길,양천구,신정7동,927258,16289,2102,623544,303723,450745,476511,7970,8319,1256,846
2019년1분기,골목상권,목동동로12길,양천구,목1동,1946574,22449,7956,1371436,575135,942752,1003819,10781,11668,3930,4026
2019년2분기,골목상권,목동동로12길,양천구,목1동,2281667,22449,14160,1567031,714649,1078820,1202844,10781,11668,7959,6201
2019년1분기,골목상권,강서로5라길,강서구,화곡2동,1402892,22667,2754,986877,416019,729197,673693,11086,11581,1453,1301
2019년2분기,골목상권,강서로5라길,강서구,화곡2동,1584898,22667,2427,1099179,485705,805914,778988,11086,11581,1471,956
2019년1분기,골목상권,강서로8길,강서구,화곡8동,3889205,24250,3851,2793644,1095580,2010343,1878866,11851,12399,1897,1954
2019년2분기,골목상권,강서로8길,강서구,화곡8동,4296295,24250,2680,3049985,1246292,2153205,2143093,11851,12399,1549,1131
2019년1분기,골목상권,개화동로23길,강서구,방화2동,1024434,16890,39856,721833,302613,546160,478277,8359,8531,22883,16973
2019년2분기,골목상권,개화동로23길,강서구,방화2동,1312433,16890,32664,917952,394487,704282,608146,8359,8531,17061,15603
2019년1분기,골목상권,개봉로20길,구로구,개봉2동,800844,27109,2166,558457,242388,399152,401693,13256,13853,977,1189
2019년2분기,골목상권,개봉로20길,구로구,개봉2동,924668,27109,7036,633373,291295,452519,472144,13256,13853,3927,3109
2019년1분기,골목상권,개봉로23가길,구로구,개봉1동,1023406,24422,4807,718047,305353,516764,506646,11925,12497,2723,2084
2019년2분기,골목상권,개봉로23가길,구로구,개봉1동,1222691,24422,7315,850586,372104,614939,607749,11925,12497,3759,3556
2019년1분기,골목상권,개봉로2길,구로구,개봉3동,1202336,21290,5376,842473,359868,601483,600855,10380,10910,2739,2637
2019년2분기,골목상권,개봉로2길,구로구,개봉3동,1334309,21290,5507,919016,415292,652639,681666,10380,10910,2892,2615
2019년1분기,골목상권,신길로42길,영등포구,신길4동,1329237,13689,1593,934662,394582,695637,633612,6844,6845,783,810
2019년2분기,골목상권,신길로42길,영등포구,신길4동,1529326,13689,2220,1050063,479247,788714,740605,6844,6845,1289,931
2019년1분기,골목상권,신길로60길,영등포구,영등포본동,1644410,14780,2773,1185337,459077,876904,767521,7586,7194,1300,1473
2019년2분기,골목상권,신길로60길,영등포구,영등포본동,1924412,14780,2210,1364011,560407,1016582,907824,7586,7194,1243,967
2019년1분기,골목상권,양평로19길,영등포구,양평2동,1069720,14671,33984,836282,233451,583126,486597,7266,7405,18252,15732
2019년2분기,골목상권,양평로19길,영등포구,양평2동,1327389,14671,13383,1027600,299789,716883,610509,7266,7405,7393,5990
2019년1분기,골목상권,목동동로8길,양천구,신정2동,526175,15355,2359,371987,154197,239605,286577,7585,7770,946,1413
2019년2분기,골목상권,목동동로8길,양천구,신정2동,609834,15355,8127,425014,184823,263057,346781,7585,7770,5212,2915
2019년1분기,골목상권,목동로19길,양천구,신정4동,1856242,17127,5437,1372644,483602,960514,895740,8361,8766,2412,3025
2019년2분기,골목상권,목동로19길,양천구,신정4동,2177366,17127,3566,1582106,595257,1114627,1062742,8361,8766,1791,1775
2019년1분기,골목상권,목동로9길,양천구,신정4동,1848116,18308,5490,1372875,475236,946050,902077,8879,9429,2511,2979
2019년2분기,골목상권,목동로9길,양천구,신정4동,2109895,18308,3654,1541959,567942,1064349,1045549,8879,9429,2078,1576
2019년1분기,골목상권,개화동로25길,강서구,방화2동,779644,11097,40321,553902,225742,416321,363329,5484,5613,23200,17121
2019년2분기,골목상권,개화동로25길,강서구,방화2동,996529,11097,31997,704754,291775,540469,456058,5484,5613,16838,15159
2019년1분기,골목상권,곰달래로25길,강서구,화곡8동,3545076,22248,2681,2556163,988918,1801642,1743440,10632,11616,957,1724
2019년2분기,골목상권,곰달래로25길,강서구,화곡8동,4053325,22248,1599,2901133,1152169,1987031,2066299,10632,11616,840,759
2019년1분기,골목상권,곰달래로31길,강서구,화곡2동,2053209,27603,1945,1453481,599728,1059742,993456,13351,14252,720,1225
2019년2분기,골목상권,곰달래로31길,강서구,화곡2동,2444944,27603,2368,1724006,720926,1241965,1202987,13351,14252,1344,1024
2019년1분기,골목상권,개봉로3길,구로구,개봉3동,926488,17741,4709,654094,272403,462346,464137,8739,9002,2543,2166
2019년2분기,골목상권,개봉로3길,구로구,개봉3동,1024653,17741,1385,709596,315060,508218,516435,8739,9002,792,593
2019년1분기,골목상권,경인로15길,구로구,오류1동,474747,16658,2475,329413,145328,251358,223381,8151,8507,1504,971
2019년2분기,골목상권,경인로15길,구로구,오류1동,593371,16658,1979,403363,189992,298547,294823,8151,8507,1220,759
2019년1분기,골목상권,경인로31길,구로구,개봉1동,691420,14791,1433,474471,216947,363901,327534,7444,7347,621,812
2019년2분기,골목상권,경인로31길,구로구,개봉1동,865040,14791,1349,581299,283737,449190,415844,7444,7347,773,576
2019년1분기,골목상권,영등포로25길,영등포구,당산1동,1225910,15705,11000,901859,324060,690106,535813,7753,7952,5464,5536
2019년2분기,골목상권,영등포로25길,영등포구,당산1동,1449740,15705,9035,1067111,382630,784233,665508,7753,7952,5218,3817
2019년1분기,골목상권,영등포로27길,영등포구,당산1동,1248032,16551,8617,899949,348089,696475,551566,8395,8156,4214,4403
2019년2분기,골목상권,영등포로27길,영등포구,당산1동,1477237,16551,7457,1064640,412601,796274,680965,8395,8156,4351,3106
2019년1분기,골목상권,영등포로35길,영등포구,영등포동,2635940,12681,7506,1814114,821829,1318851,1317091,6810,5871,3614,3892
2019년2분기,골목상권,영등포로35길,영등포구,영등포동,3144945,12681,4816,2138749,1006199,1548378,1596569,6810,5871,2883,1933
2019년1분기,골목상권,목동중앙남로3가길,양천구,목4동,1214138,22738,1769,869792,344351,609392,604748,11281,11457,801,968
2019년2분기,골목상권,목동중앙남로3가길,양천구,목4동,1268514,22738,1828,883196,385309,633298,635211,11281,11457,981,847
2019년1분기,골목상권,목동중앙로13나길,양천구,목2동,139519,5681,1571,100900,38617,74540,64978,2859,2822,1007,564
2019년2분기,골목상권,목동중앙로13나길,양천구,목2동,186094,5681,1457,131894,54206,102058,84035,2859,2822,850,607
2019년1분기,골목상권,목동중앙로3길,양천구,목4동,1677209,22932,1397,1190501,486715,815351,861857,11453,11479,532,865
2019년2분기,골목상권,목동중앙로3길,양천구,목4동,1079796,22932,2755,736252,343545,539173,540632,11453,11479,1310,1445
2019년1분기,골목상권,곰달래로47길,강서구,화곡2동,959240,23583,1245,657377,301856,462539,496697,11568,12015,464,781
2019년2분기,골목상권,곰달래로47길,강서구,화곡2동,1188093,23583,2054,797507,390582,567960,620135,11568,12015,1053,1001
2019년1분기,골목상권,곰달래로53길,강서구,화곡4동,751342,23624,1015,522156,229179,359607,391736,11584,12040,410,605
2019년2분기,골목상권,곰달래로53길,강서구,화곡4동,950860,23624,1048,645548,305307,437382,513475,11584,12040,591,457
2019년1분기,골목상권,곰달래로60길,강서구,화곡4동,1145176,17335,3422,809885,335306,577121,568060,8382,8953,1485,1937
2019년2분기,골목상권,곰달래로60길,강서구,화곡4동,1366559,17335,4139,952523,414034,673351,693205,8382,8953,1802,2337
2019년1분기,골목상권,경인로35길,구로구,개봉1동,969734,20059,2407,658070,311651,505067,464675,10091,9968,1170,1237
2019년2분기,골목상권,경인로35길,구로구,개봉1동,1194341,20059,3243,800529,393801,617008,577330,10091,9968,1904,1339
2019년1분기,골목상권,경인로47길,구로구,고척1동,1014417,14537,4608,737417,276994,544935,469481,7322,7215,2738,1870
2019년2분기,골목상권,경인로47길,구로구,고척1동,1299445,14537,3463,956107,343339,739729,559712,7322,7215,2253,1210
2019년1분기,골목상권,고척로21나길,구로구,개봉1동,636361,19426,1453,436628,199740,322332,314037,9769,9657,487,966
2019년2분기,골목상권,고척로21나길,구로구,개봉1동,756102,19426,2488,506765,249353,375934,380174,9769,9657,1503,985
2019년1분기,골목상권,양평로22라길,영등포구,양평2동,552637,9421,19202,431951,120688,303615,249025,4683,4738,12418,6784
2019년2분기,골목상권,양평로22라길,영등포구,양평2동,704316,9421,4280,541720,162595,378680,325633,4683,4738,2580,1700
2019년1분기,골목상권,양평로28길,영등포구,양평2동,345363,9114,14456,261712,83651,192734,152633,4562,4552,9236,5220
2019년2분기,골목상권,양평로28길,영등포구,양평2동,460883,9114,4368,341707,119183,247605,213277,4562,4552,2776,1592
2019년1분기,골목상권,여의대방로35길,영등포구,신길6동,1353700,13098,4563,975585,378105,728840,624863,6486,6612,2645,1918
2019년2분기,골목상권,여의대방로35길,영등포구,신길6동,1565727,13098,3426,1105597,460124,835400,730325,6486,6612,2054,1372
2019년1분기,골목상권,목동중앙본로7길,양천구,목4동,1980684,24065,1719,1405372,575321,984289,996397,11871,12194,711,1008
2019년2분기,골목상권,목동중앙본로7길,양천구,목4동,1497908,24065,1678,1029012,468897,750667,747247,11871,12194,853,825
2019년1분기,골목상권,목동중앙북로16길,양천구,목2동,802301,19108,3014,571829,230475,416891,385409,9254,9854,1697,1317
2019년2분기,골목상권,목동중앙북로16길,양천구,목2동,975922,19108,4793,688667,287264,497255,478663,9254,9854,2804,1989
2019년1분기,골목상권,목동중앙북로8길,양천구,목3동,1251272,19737,2966,897267,354018,631557,619716,9488,10249,1375,1591
2019년2분기,골목상권,목동중앙북로8길,양천구,목3동,1499215,19737,5428,1062067,437159,735073,764139,9488,10249,3101,2327
2019년1분기,골목상권,공항대로38길,강서구,우장산동,1557706,9963,5875,1107679,450039,750866,806843,4671,5292,2921,2954
2019년2분기,골목상권,공항대로38길,강서구,우장산동,1952175,9963,3562,1373261,578911,912407,1039771,4671,5292,1756,1806
2019년1분기,골목상권,공항대로42길,강서구,우장산동,1363914,11830,5217,952516,411415,651439,712474,5696,6134,2421,2796
2019년2분기,골목상권,공항대로42길,강서구,우장산동,1677490,11830,2726,1156530,520964,776819,900671,5696,6134,1437,1289
2019년1분기,골목상권,공항대로55길,강서구,등촌1동,672776,15086,16672,495728,177046,355604,317170,7229,7857,9772,6900
2019년2분기,골목상권,공항대로55길,강서구,등촌1동,795450,15086,10063,582369,213092,416486,378968,7229,7857,6402,3661
2019년1분기,골목상권,고척로27길,구로구,개봉1동,836949,19011,1223,586005,250942,422180,414771,9490,9521,489,734
2019년2분기,골목상권,고척로27길,구로구,개봉1동,1027651,19011,1590,699725,327928,516783,510872,9490,9521,913,677
2019년1분기,골목상권,고척로27다길,구로구,고척2동,815586,17944,1205,574337,241247,411654,403932,8922,9022,461,744
2019년2분기,골목상권,고척로27다길,구로구,고척2동,1066091,17944,1318,727255,338836,535997,530099,8922,9022,740,578
2019년1분기,골목상권,고척로52길,구로구,고척1동,719482,17299,2922,481881,237595,380935,338550,8768,8531,1661,1261
2019년2분기,골목상권,고척로52길,구로구,고척1동,880188,17299,5366,585193,294984,462386,417795,8768,8531,3884,1482
2019년1분기,골목상권,여의대방로39길,영등포구,신길7동,647456,6581,2791,466393,181049,348218,299234,3285,3296,1527,1264
2019년2분기,골목상권,여의대방로39길,영등포구,신길7동,809465,6581,4921,567324,242140,427248,382216,3285,3296,3547,1374
2019년1분기,골목상권,여의대방로43나길,영등포구,신길7동,1467422,23272,3342,1031223,436189,752080,715342,11501,11771,1876,1466
2019년2분기,골목상권,여의대방로43나길,영등포구,신길7동,1725040,23272,5861,1184303,540748,882250,842798,11501,11771,4249,1612
2019년1분기,골목상권,여의대방로61길,영등포구,신길1동,1069961,9447,3359,784133,285829,556585,513380,4794,4653,1704,1655
2019년2분기,골목상권,여의대방로61길,영등포구,신길1동,1277019,9447,3778,923969,353062,669314,607708,4794,4653,1851,1927
2019년1분기,골목상권,목동중앙서로7길,양천구,목4동,1128522,26599,2513,799285,329265,568284,560239,13082,13517,1195,1318
2019년2분기,골목상권,목동중앙서로7길,양천구,목4동,1347011,26599,4466,935028,411981,665254,681762,13082,13517,2400,2066
2019년1분기,골목상권,목동중앙서로8가길,양천구,목4동,848385,16661,2456,598931,249474,426561,421828,8076,8585,1071,1385
2019년2분기,골목상권,목동중앙서로8가길,양천구,목4동,1014402,16661,3906,705070,309341,500130,514271,8076,8585,1874,2032
2019년1분기,골목상권,신목로2길,양천구,신정2동,1125390,23261,1889,793070,332318,543804,581587,11330,11931,839,1050
2019년2분기,골목상권,신목로2길,양천구,신정2동,1276184,23261,6261,879937,396258,593010,683177,11330,11931,3663,2598
2019년1분기,골목상권,공항대로59길,강서구,등촌1동,1373459,19517,5653,1026486,346975,710416,663039,9408,10109,3160,2493
2019년2분기,골목상권,공항대로59길,강서구,등촌1동,1654728,19517,6250,1230879,423856,845850,808879,9408,10109,4328,1922
2019년1분기,골목상권,공항대로59다길,강서구,염창동,1985986,22953,6315,1462684,523311,993659,992326,11172,11781,3404,2911
2019년2분기,골목상권,공항대로59다길,강서구,염창동,2414682,22953,6526,1761259,653438,1186980,1227704,11172,11781,4062,2464
2019년1분기,골목상권,공항대로61길,강서구,염창동,1581764,18506,5631,1177981,403789,803724,778039,8917,9589,3083,2548
2019년2분기,골목상권,공항대로61길,강서구,염창동,1936980,18506,5840,1433488,503488,969065,967915,8917,9589,4057,1783
2019년1분기,골목상권,공원로6가길,구로구,구로5동,1086219,18880,9060,761780,324443,560820,525397,9071,9809,4430,4630
2019년2분기,골목상권,공원로6가길,구로구,구로5동,1314435,18880,11445,913176,401264,672421,642013,9071,9809,5899,5546
2019년1분기,골목상권,구로동로15길,구로구,구로2동,1039880,11129,18927,749955,289942,554164,485723,5757,5372,12698,6229
2019년2분기,골목상권,구로동로15길,구로구,구로2동,1373285,11129,12442,975998,397299,726206,647080,5757,5372,8644,3798
2019년1분기,골목상권,구로동로28길,구로구,구로2동,1476852,16315,7572,1066362,410499,775178,701685,8074,8241,3327,4245
2019년2분기,골목상권,구로동로28길,구로구,구로2동,1800826,16315,4145,1289949,510887,927711,873113,8074,8241,2368,1777
2019년1분기,골목상권,영등포로62길,영등포구,영등포본동,1091314,12634,2870,785922,305399,575611,515708,6447,6187,1399,1471
2019년2분기,골목상권,영등포로62길,영등포구,영등포본동,1310996,12634,1640,930734,380254,689552,621438,6447,6187,874,766
2019년1분기,골목상권,영등포로80길,영등포구,신길1동,2103141,15934,4030,1518297,584834,1068398,1034739,8095,7839,1961,2069
2019년2분기,골목상권,영등포로80길,영등포구,신길1동,2466589,15934,4075,1761448,705161,1264570,1202018,8095,7839,1935,2140
2019년1분기,골목상권,영등포로84길,영등포구,신길1동,2038065,17811,3856,1459712,578343,1034303,1003755,9002,8809,2022,1834
2019년2분기,골목상권,영등포로84길,영등포구,신길1동,2387188,17811,4371,1689201,698019,1214416,1172781,9002,8809,2067,2304
2019년1분기,골목상권,신목로5길,양천구,신정2동,867218,21515,3233,617903,249321,410253,456972,10535,10980,1670,1563
2019년2분기,골목상권,신목로5길,양천구,신정2동,979539,21515,11375,683924,295621,443360,536180,10535,10980,7572,3803
2019년1분기,골목상권,신목로6길,양천구,신정2동,1574946,25382,3332,1108926,466018,762203,812745,12364,13018,1349,1983
2019년2분기,골목상권,신목로6길,양천구,신정2동,1818691,25382,7112,1254411,564289,850431,968258,12364,13018,4088,3024
2019년1분기,골목상권,신월로15길,양천구,신월4동,1263660,19087,3102,915018,348636,675709,587946,9390,9697,1818,1284
2019년2분기,골목상권,신월로15길,양천구,신월4동,1363279,19087,2597,967241,396039,724498,638781,9390,9697,1802,795
2019년1분기,골목상권,공항대로8길,강서구,공항동,926332,17256,3249,667548,258787,518116,408220,8760,8496,1946,1303
2019년2분기,골목상권,공항대로8길,강서구,공항동,1305543,17256,2283,927505,378042,728846,576701,8760,8496,1489,794
2019년1분기,골목상권,국회대로7길,강서구,화곡2동,1175577,19999,2892,822152,353435,603460,572119,9753,10246,1525,1367
2019년2분기,골목상권,국회대로7길,강서구,화곡2동,1390206,19999,3617,957481,432720,695652,694548,9753,10246,1767,1850
2019년1분기,골목상권,까치산로4길,강서구,화곡본동,1560815,28054,2193,1101425,459382,747326,813483,13642,14412,771,1422
2019년2분기,골목상권,까치산로4길,강서구,화곡본동,1854259,28054,3174,1297144,557118,885664,968600,13642,14412,1709,1465
2019년1분기,골목상권,구로동로38길,구로구,구로2동,1411813,12933,7125,1040334,371481,741022,670794,6496,6437,3097,4028
2019년2분기,골목상권,구로동로38길,구로구,구로2동,1665482,12933,4396,1214230,451267,865746,799734,6496,6437,2501,1895
2019년1분기,골목상권,구로동로41길,구로구,구로2동,1157302,12837,3852,842371,314932,608684,548619,6474,6363,1157,2695
2019년2분기,골목상권,구로동로41길,구로구,구로2동,1341161,12837,1287,960495,380680,703239,637914,6474,6363,615,672
2019년1분기,골목상권,구로동로42길,구로구,구로2동,1419883,16176,4859,996230,423652,730398,689480,8075,8101,2309,2550
2019년2분기,골목상권,구로동로42길,구로구,구로2동,1636370,16176,5118,1133472,502911,838949,797416,8075,8101,2589,2529
2019년1분기,골목상권,신촌로30길,마포구,아현동,1635830,13040,1656,1198334,437501,753476,882352,6186,6854,629,1027
2019년2분기,골목상권,신촌로30길,마포구,아현동,1958975,13040,1451,1424435,534542,893317,1065652,6186,6854,756,695
2019년1분기,골목상권,양화로11길,마포구,서교동,2515381,8213,15439,1811967,703421,1223601,1291782,3792,4421,7711,7728
2019년2분기,골목상권,양화로11길,마포구,서교동,2950542,8213,12280,2105949,844597,1419962,1530580,3792,4421,6156,6124
2019년1분기,골목상권,양화로1길,마포구,합정동,1620776,15489,9172,1147461,473319,775492,845285,7267,8222,4769,4403
2019년2분기,골목상권,양화로1길,마포구,합정동,1989509,15489,4874,1398028,591485,932971,1056542,7267,8222,2694,2180
2019년1분기,골목상권,신월로20길,양천구,신월6동,826335,16514,1490,597786,228542,455797,370532,8141,8373,666,824
2019년2분기,골목상권,신월로20길,양천구,신월6동,939611,16514,1716,668713,270900,512647,426972,8141,8373,1052,664
2019년1분기,골목상권,오목로23길,양천구,신정4동,1511117,19830,3228,1078149,432972,808508,702610,9856,9974,1713,1515
2019년2분기,골목상권,오목로23길,양천구,신정4동,1683792,19830,3796,1183940,499856,884069,799718,9856,9974,2006,1790
2019년1분기,골목상권,오목로30길,양천구,신정4동,1409218,23419,3399,1009712,399508,720727,688489,11605,11814,1586,1813
2019년2분기,골목상권,오목로30길,양천구,신정4동,1659795,23419,3177,1171720,488079,849284,810511,11605,11814,1400,1777
2019년1분기,골목상권,남부순환로11길,강서구,공항동,728797,14488,2517,533319,195485,421283,307515,7451,7037,1644,873
2019년2분기,골목상권,남부순환로11길,강서구,공항동,1138247,14488,1621,804199,334055,643600,494650,7451,7037,1147,474
2019년1분기,골목상권,등촌로13길,강서구,화곡4동,1006757,22932,1795,709480,297279,497607,509151,11315,11617,744,1051
2019년2분기,골목상권,등촌로13길,강서구,화곡4동,1231071,22932,1278,850891,380173,591925,639149,11315,11617,746,532
2019년1분기,골목상권,등촌로39길,강서구,등촌2동,583777,16550,1626,414948,168832,307028,276752,8132,8418,667,959
2019년2분기,골목상권,등촌로39길,강서구,등촌2동,717912,16550,3771,500000,217911,358607,359304,8132,8418,2103,1668
2019년1분기,골목상권,구로동로7길,구로구,가리봉동,1471624,15874,19295,1052008,419625,825150,646484,8249,7625,12940,6355
2019년2분기,골목상권,구로동로7길,구로구,가리봉동,1845017,15874,12781,1299687,545340,1020040,824979,8249,7625,8818,3963
2019년1분기,골목상권,구로동로8길,구로구,구로4동,2302637,27549,2198,1631670,670994,1255475,1047189,13833,13716,878,1320
2019년2분기,골목상권,구로동로8길,구로구,구로4동,2829332,27549,1777,1973564,855788,1513006,1316330,13833,13716,922,855
2019년1분기,골목상권,구로중앙로19길,구로구,구로2동,1177746,13160,8154,859841,317912,617260,560490,6459,6701,3667,4487
2019년2분기,골목상권,구로중앙로19길,구로구,구로2동,1410141,13160,4824,1019998,390139,721160,688985,6459,6701,2726,2098
2019년1분기,골목상권,양화진길,마포구,합정동,1760212,9050,10152,1250748,509473,876524,883693,4312,4738,5309,4843
2019년2분기,골목상권,양화진길,마포구,합정동,2240792,9050,4337,1571790,668997,1082889,1157903,4312,4738,2477,1860
2019년1분기,골목상권,와우산로29가길,마포구,서교동,2083147,7704,7546,1413162,669975,925659,1157492,3711,3993,4678,2868
2019년2분기,골목상권,와우산로29가길,마포구,서교동,2594922,7704,4905,1756599,838329,1145065,1449857,3711,3993,3307,1598
2019년1분기,골목상권,와우산로29길,마포구,서교동,2166254,7286,9758,1464514,701734,960929,1205333,3454,3832,5155,4603
2019년2분기,골목상권,와우산로29길,마포구,서교동,2542658,7286,2707,1692420,850241,1117914,1424744,3454,3832,1512,1195
2019년1분기,골목상권,오목로3길,양천구,신월4동,925199,22152,3112,651791,273423,494599,430609,11061,11091,2075,1037
2019년2분기,골목상권,오목로3길,양천구,신월4동,1070522,22152,2529,736181,334355,565871,504647,11061,11091,1819,710
2019년1분기,골목상권,오목로5길,양천구,신월4동,1522178,22851,2734,1067050,455145,769993,752196,11350,11501,1594,1140
2019년2분기,골목상권,오목로5길,양천구,신월4동,1217710,22851,2214,834439,383280,624988,592718,11350,11501,1397,817
2019년1분기,골목상권,은행정로5길,양천구,신정1동,1195875,15802,2810,868721,327155,612979,582893,7755,8047,1225,1585
2019년2분기,골목상권,은행정로5길,양천구,신정1동,1367409,15802,1363,981702,385708,691529,675876,7755,8047,647,716
2019년1분기,골목상권,등촌로51길,강서구,등촌2동,811930,15345,3334,590249,221685,411678,400257,7475,7870,1622,1712
2019년2분기,골목상권,등촌로51길,강서구,등촌2동,967281,15345,2262,695062,272225,476827,490453,7475,7870,1385,877
2019년1분기,골목상권,등촌로55길,강서구,등촌2동,832278,13815,4290,612451,219827,420581,411695,6697,7118,2307,1983
2019년2분기,골목상권,등촌로55길,강서구,등촌2동,999532,13815,2909,730690,268856,497046,502487,6697,7118,1850,1059
2019년1분기,골목상권,등촌로5길,강서구,화곡4동,1060266,20935,2451,746941,313345,522634,537632,10258,10677,1147,1304
2019년2분기,골목상권,등촌로5길,강서구,화곡4동,1286106,20935,2969,894479,391628,618757,667344,10258,10677,1367,1602
2019년1분기,골목상권,구로중앙로28길,구로구,구로5동,1695568,21559,15388,1206778,488799,886455,809107,10415,11144,10099,5289
2019년2분기,골목상권,구로중앙로28길,구로구,구로5동,2019747,21559,12917,1427800,591949,1042240,977510,10415,11144,8903,4014
2019년1분기,골목상권,구로중앙로34길,구로구,구로5동,1445398,13122,5179,995743,449665,738255,707136,6435,6687,2864,2315
2019년2분기,골목상권,구로중앙로34길,구로구,구로5동,1749230,13122,3914,1195061,554166,887213,862013,6435,6687,2287,1627
2019년1분기,골목상권,구로중앙로42길,구로구,신도림동,551069,10534,10057,408071,142991,312917,238141,5331,5203,6601,3456
2019년2분기,골목상권,구로중앙로42길,구로구,신도림동,660892,10534,8996,482035,178861,362187,298705,5331,5203,6446,2550
2019년1분기,골목상권,와우산로3길,마포구,서강동,1977070,9016,6207,1324267,652813,971249,1005815,4233,4783,3604,2603
2019년2분기,골목상권,와우산로3길,마포구,서강동,2355421,9016,4840,1567986,787446,1148970,1206451,4233,4783,3024,1816
2019년1분기,골목상권,월드컵로10길,마포구,서교동,2081856,15247,12090,1524963,556879,984654,1097208,7008,8239,5773,6317
2019년2분기,골목상권,월드컵로10길,마포구,서교동,2552403,15247,8335,1858140,694270,1205993,1346409,7008,8239,3925,4410
2019년1분기,골목상권,월드컵로11길,마포구,망원1동,2032054,19938,6592,1420152,611890,934197,1097862,9219,10719,3155,3437
2019년2분기,골목상권,월드컵로11길,마포구,망원1동,2487460,19938,3757,1730011,757457,1142219,1345244,9219,10719,2051,1706
2019년1분기,골목상권,은행정로7길,양천구,신정4동,1592817,20572,3745,1154300,438517,816374,776441,10191,10381,1691,2054
2019년2분기,골목상권,은행정로7길,양천구,신정4동,1868415,20572,2877,1334964,533453,953303,915111,10191,10381,1298,1579
2019년1분기,골목상권,중앙로25길,양천구,신정3동,748876,15861,1994,534778,214092,413656,335214,7987,7874,859,1135
2019년2분기,골목상권,중앙로25길,양천구,신정3동,910312,15861,7070,639134,271191,492036,418279,7987,7874,4391,2679
2019년1분기,골목상권,중앙로32길,양천구,신정1동,986838,14003,3963,731781,255063,498948,487892,6822,7181,2005,1958
2019년2분기,골목상권,중앙로32길,양천구,신정1동,1135672,14003,9685,830326,305344,565403,570265,6822,7181,5589,4096
2019년1분기,골목상권,방화대로21길,강서구,공항동,730054,14519,2587,520862,209199,407710,322343,7284,7235,1383,1204
2019년2분기,골목상권,방화대로21길,강서구,공항동,905039,14519,2569,641548,263502,502655,402385,7284,7235,1400,1169
2019년1분기,골목상권,방화대로6라길,강서구,공항동,408863,9763,3479,298830,110033,237304,171563,5000,4763,2171,1308
2019년2분기,골목상권,방화대로6라길,강서구,공항동,602393,9763,1662,424203,178189,351907,250486,5000,4763,1051,611
2019년1분기,골목상권,양천로14길,강서구,방화2동,1170172,22341,4034,846191,323978,614002,556172,10997,11344,2009,2025
2019년2분기,골목상권,양천로14길,강서구,방화2동,1419040,22341,3537,1014342,404694,737364,681662,10997,11344,2332,1205
2019년1분기,골목상권,구로중앙로7길,구로구,구로4동,1335339,20275,2343,923202,412141,708245,627105,9961,10314,1233,1110
2019년2분기,골목상권,구로중앙로7길,구로구,구로4동,1604147,20275,1798,1091654,512500,832582,771561,9961,10314,1107,691
2019년1분기,골목상권,구로중앙로8길,구로구,구로4동,1997205,17318,3908,1364844,632368,1060792,936418,8407,8911,2177,1731
2019년2분기,골목상권,구로중앙로8길,구로구,구로4동,2385100,17318,3214,1600505,784604,1253181,1131927,8407,8911,1926,1288
2019년1분기,골목상권,남부순환로97길,구로구,개봉2동,749170,18662,2053,522032,227138,379434,369736,9120,9542,1021,1032
2019년2분기,골목상권,남부순환로97길,구로구,개봉2동,880854,18662,6447,605497,275360,441526,439325,9120,9542,3655,2792
2019년1분기,골목상권,월드컵로16길,마포구,서교동,1824295,18731,8954,1323945,500348,852868,971434,8745,9986,4663,4291
2019년2분기,골목상권,월드컵로16길,마포구,서교동,2235009,18731,9404,1611231,623792,1044481,1190526,8745,9986,6188,3216
2019년1분기,골목상권,월드컵로19길,마포구,망원1동,1918682,17853,7247,1351108,567568,883202,1035486,8310,9543,3898,3349
2019년2분기,골목상권,월드컵로19길,마포구,망원1동,2342929,17853,7958,1641443,701492,1077988,1264941,8310,9543,5447,2511
2019년1분기,골목상권,월드컵로25길,마포구,망원2동,1629562,24795,2313,1125354,504206,792142,837417,11844,12951,1250,1063
2019년2분기,골목상권,월드컵로25길,마포구,망원2동,2052297,24795,2275,1377562,674751,968395,1083901,11844,12951,1280,995
2019년1분기,골목상권,중앙로36길,양천구,신정1동,1161948,14860,2431,840497,321460,609693,552249,7320,7540,1116,1315
2019년2분기,골목상권,중앙로36길,양천구,신정1동,1357783,14860,877,972840,384954,697531,660244,7320,7540,421,456
2019년1분기,골목상권,중앙로45길,양천구,신정3동,1027828,18545,2314,722585,305233,541321,486512,9171,9374,1037,1277
2019년2분기,골목상권,중앙로45길,양천구,신정3동,1223414,18545,3681,851225,372195,640874,582531,9171,9374,2722,959
2019년1분기,골목상권,중앙로47길,양천구,신정3동,1028744,16242,2188,733482,295248,564463,464281,8170,8072,936,1252
2019년2분기,골목상권,중앙로47길,양천구,신정3동,1219699,16242,3953,857649,362063,654895,564809,8170,8072,2972,981
2019년1분기,골목상권,양천로24가길,강서구,방화1동,1160759,21254,3730,834492,326271,611839,548925,10528,10726,1789,1941
2019년2분기,골목상권,양천로24가길,강서구,방화1동,1342353,21254,3415,950405,391955,690626,651721,10528,10726,2235,1180
2019년1분기,골목상권,양천로24길,강서구,방화1동,1054004,20712,3652,748642,305373,555632,498371,10192,10520,1779,1873
2019년2분기,골목상권,양천로24길,강서구,방화1동,1234452,20712,2263,864711,369747,635982,598469,10192,10520,1364,899
2019년1분기,골목상권,양천로26길,강서구,방화1동,310025,20517,7874,219188,90847,166120,143907,9829,10688,4101,3773
2019년2분기,골목상권,양천로26길,강서구,방화1동,377050,20517,2408,261703,115351,194619,182436,9829,10688,1366,1042
2019년1분기,골목상권,도림로12길,구로구,구로3동,1629488,20724,11359,1172695,456794,912339,717160,10287,10437,5384,5975
2019년2분기,골목상권,도림로12길,구로구,구로3동,1979786,20724,5643,1400083,579726,1082863,896927,10287,10437,3828,1815
2019년1분기,골목상권,디지털로32가길,구로구,구로3동,2476987,14578,46190,1894743,582250,1438527,1038460,7914,6664,28360,17830
2019년2분기,골목상권,디지털로32가길,구로구,구로3동,2834095,14578,32787,2164937,669167,1615579,1218521,7914,6664,19823,12964
2019년1분기,골목상권,디지털로32길,구로구,구로3동,2698045,12814,44001,2040481,657562,1550395,1147654,6772,6042,26720,17281
2019년2분기,골목상권,디지털로32길,구로구,구로3동,3107472,12814,33210,2339013,768466,1754555,1352925,6772,6042,19957,13253
2019년1분기,골목상권,월드컵로36길,마포구,성산2동,1087580,25191,8254,772665,314904,513911,573670,11744,13447,3407,4847
2019년2분기,골목상권,월드컵로36길,마포구,성산2동,1317265,25191,3068,917233,400042,616174,701091,11744,13447,1463,1605
2019년1분기,골목상권,월드컵로7길,마포구,합정동,2043337,16843,7140,1449597,593736,959496,1083841,7732,9111,3910,3230
2019년2분기,골목상권,월드컵로7길,마포구,합정동,2457834,16843,5092,1732832,724996,1145035,1312798,7732,9111,2673,2419
2019년1분기,골목상권,월드컵로8길,마포구,서교동,2390812,11982,15904,1749726,641092,1157958,1232863,5539,6443,8137,7767
2019년2분기,골목상권,월드컵로8길,마포구,서교동,2851016,11982,12870,2069898,781112,1370551,1480463,5539,6443,6599,6271
2019년1분기,골목상권,중앙로51길,양천구,신월2동,1464091,24244,2203,1010308,453802,717645,746455,11884,12360,1035,1168
2019년2분기,골목상권,중앙로51길,양천구,신월2동,1062281,24244,3131,710595,351684,531213,531067,11884,12360,1839,1292
2019년1분기,골목상권,중앙로55길,양천구,신월2동,1653704,19923,2824,1154809,498912,833772,819933,9952,9971,1420,1404
2019년2분기,골목상권,중앙로55길,양천구,신월2동,1279487,19923,2694,874291,405181,655256,624231,9952,9971,1503,1191
2019년1분기,골목상권,지양로7길,양천구,신월7동,320726,15477,1897,225822,94911,179696,141025,7605,7872,1188,709
2019년2분기,골목상권,지양로7길,양천구,신월7동,415038,15477,2787,283830,131211,225892,189150,7605,7872,1610,1177
2019년1분기,골목상권,양천로49길,강서구,가양1동,330109,9904,6966,247684,82427,173818,156287,4833,5071,3821,3145
2019년2분기,골목상권,양천로49길,강서구,가양1동,420932,9904,6378,317232,103699,220847,200093,4833,5071,3772,2606
2019년1분기,골목상권,양천로71길,강서구,염창동,1151992,23943,2748,831061,320945,576484,575519,11707,12236,1469,1279
2019년2분기,골목상권,양천로71길,강서구,염창동,1358599,23943,4714,966059,392550,668224,690387,11707,12236,2937,1777
2019년1분기,골목상권,양천로73가길,강서구,염창동,1185247,21210,4584,841221,344032,608646,576607,10336,10874,2971,1613
2019년2분기,골목상권,양천로73가길,강서구,염창동,1421600,21210,4343,994728,426894,717045,704568,10336,10874,2966,1377
2019년1분기,골목상권,도림로112길,영등포구,도림동,1722792,22080,1619,1199795,522996,850945,871847,11144,10936,788,831
2019년2분기,골목상권,도림로112길,영등포구,도림동,1758451,22080,2449,1195285,563178,877352,881107,11144,10936,1706,743
2019년1분기,골목상권,도림로147길,영등포구,문래동,795408,13160,9735,603188,192222,440037,355371,6499,6661,5971,3764
2019년2분기,골목상권,도림로147길,영등포구,문래동,928483,13160,8225,697245,231236,508244,420235,6499,6661,4639,3586
2019년1분기,골목상권,도림로63길,영등포구,신길5동,924944,14971,1802,664359,260612,506032,418915,7531,7440,959,843
2019년2분기,골목상권,도림로63길,영등포구,신길5동,1202302,14971,1332,851488,350821,641070,561240,7531,7440,884,448
2019년1분기,골목상권,토정로37길,마포구,용강동,2472878,18205,19313,1933167,539723,1317204,1155665,8698,9507,11467,7846
2019년2분기,골목상권,토정로37길,마포구,용강동,2872511,18205,19071,2228414,644100,1485065,1387452,8698,9507,12015,7056
2019년1분기,골목상권,효창원로93길,마포구,공덕동,1785952,18828,4712,1346296,439645,800690,985269,9013,9815,2204,2508
2019년2분기,골목상권,효창원로93길,마포구,공덕동,2285799,18828,3752,1730212,555609,957934,1327864,9013,9815,1950,1802
2019년1분기,골목상권,가로공원로58길,양천구,신월3동,265887,10819,1562,191075,74821,145553,120338,5789,5030,927,635
2019년2분기,골목상권,가로공원로58길,양천구,신월3동,325081,10819,992,229735,95354,172792,152294,5789,5030,630,362
2019년1분기,골목상권,화곡로3길,양천구,신월5동,250356,13744,1504,189713,60648,135381,114981,6904,6840,506,998
2019년2분기,골목상권,화곡로3길,양천구,신월5동,330750,13744,1251,240790,89965,177058,153698,6904,6840,643,608
2019년1분기,골목상권,화곡로4길,양천구,신월5동,478886,15789,3083,351939,126943,263333,215559,8069,7720,1658,1425
2019년2분기,골목상권,화곡로4길,양천구,신월5동,608182,15789,1747,438947,169244,327755,280435,8069,7720,954,793
2019년1분기,골목상권,가로공원로76가길,강서구,화곡1동,1465641,30336,2437,1015934,449701,713507,752129,14931,15405,1210,1227
2019년2분기,골목상권,가로공원로76가길,강서구,화곡1동,1776500,30336,3422,1219109,557398,837591,938910,14931,15405,2235,1187
2019년1분기,골목상권,우장산로6길,강서구,우장산동,1071961,20653,2451,813779,258187,465128,606834,9832,10821,962,1489
2019년2분기,골목상권,우장산로6길,강서구,우장산동,1503655,20653,1565,1108663,394990,650784,852877,9832,10821,839,726
2019년1분기,골목상권,월정로20길,강서구,화곡1동,1669285,22453,2006,1124000,545285,868193,801083,11253,11200,1134,872
2019년2분기,골목상권,월정로20길,강서구,화곡1동,1993090,22453,1929,1333651,659441,1015324,977767,11253,11200,1244,685
2019년1분기,골목상권,초록마을로3길,강서구,화곡본동,1329813,21510,2654,918336,411487,692155,637656,10622,10888,1529,1125
2019년2분기,골목상권,초록마을로3길,강서구,화곡본동,1533656,21510,4376,1044877,488767,784119,749540,10622,10888,2756,1620
2019년1분기,골목상권,도림천로21길,영등포구,대림2동,1903767,15993,14752,1354121,549648,1044621,859146,7906,8087,8688,6064
2019년2분기,골목상권,도림천로21길,영등포구,대림2동,2223562,15993,17407,1572447,651114,1217114,1006452,7906,8087,10208,7199
2019년1분기,골목상권,도신로15길,영등포구,도림동,1825716,21162,5323,1273554,552164,926038,899672,10581,10581,2158,3165
2019년2분기,골목상권,도신로15길,영등포구,도림동,1870462,21162,3086,1276130,594340,965480,904986,10581,10581,1983,1103
2019년1분기,골목상권,도신로29길,영등포구,도림동,1291372,20678,1208,901277,390098,640223,651146,10444,10234,523,685
2019년2분기,골목상권,도신로29길,영등포구,도림동,1453963,20678,2066,995810,458170,717410,736559,10444,10234,1362,704
2019년1분기,골목상권,곰달래로10길,양천구,신월1동,1356154,22294,2927,929520,426642,710239,645918,11320,10974,1737,1190
2019년2분기,골목상권,곰달래로10길,양천구,신월1동,1570930,22294,2234,1064416,506527,816386,754540,11320,10974,1425,809
2019년1분기,골목상권,곰달래로2길,양천구,신월1동,601967,17990,2485,417959,184012,329589,272386,9133,8857,1551,934
2019년2분기,골목상권,곰달래로2길,양천구,신월1동,757206,17990,2157,518271,238949,401531,355673,9133,8857,1431,726
2019년1분기,골목상권,곰달래로3길,양천구,신월1동,894294,22782,2731,623258,271029,461557,432736,11633,11149,1397,1334
2019년2분기,골목상권,곰달래로3길,양천구,신월1동,1092752,22782,2368,753420,339351,542793,549961,11633,11149,1325,1043
2019년1분기,골목상권,가로공원로80길,강서구,화곡1동,1059715,25314,1833,741633,318091,522670,537047,12427,12887,749,1084
2019년2분기,골목상권,가로공원로80길,강서구,화곡1동,1464616,25314,3330,1016560,448055,710310,754307,12427,12887,2035,1295
2019년1분기,골목상권,강서로15길,강서구,화곡1동,3786304,36550,3170,2643639,1142663,1878703,1907593,17947,18603,1523,1647
2019년2분기,골목상권,강서로15길,강서구,화곡1동,4379549,36550,3429,3026144,1353408,2103044,2276504,17947,18603,2229,1200
2019년1분기,골목상권,강서로17가길,강서구,화곡1동,1774974,24496,1768,1267616,507369,847082,927897,11944,12552,653,1115
2019년2분기,골목상권,강서로17가길,강서구,화곡1동,2026823,24496,2316,1427438,599374,929626,1097195,11944,12552,1411,905
2019년1분기,골목상권,초록마을로8길,강서구,화곡본동,1055777,26633,830,732968,322814,495992,559778,13044,13589,208,622
2019년2분기,골목상권,초록마을로8길,강서구,화곡본동,1237577,26633,1876,841898,395663,587279,650299,13044,13589,1091,785
2019년1분기,골목상권,초원로16길,강서구,방화1동,1040477,21170,3509,736671,303806,555057,485414,10379,10791,1831,1678
2019년2분기,골목상권,초원로16길,강서구,방화1동,1255478,21170,2324,881633,373856,661611,593864,10379,10791,1253,1071
2019년1분기,골목상권,화곡로13길,양천구,신월5동,809481,25072,1958,559579,249914,413607,395878,12242,12830,914,1044
2019년2분기,골목상권,화곡로13길,양천구,신월5동,995130,25072,2004,675349,319786,502529,492609,12242,12830,1109,895
2019년1분기,골목상권,도신로60길,영등포구,신길1동,1483945,13915,1343,1073305,410641,763533,720416,6952,6963,612,731
2019년2분기,골목상권,도신로60길,영등포구,신길1동,1740644,13915,1396,1245138,495525,909338,831309,6952,6963,776,620
2019년1분기,골목상권,도신로62길,영등포구,신길1동,1960175,15702,2799,1416050,544126,993856,966314,7923,7779,1400,1399
2019년2분기,골목상권,도신로62길,영등포구,신길1동,2273770,15702,2270,1626588,647211,1164532,1109242,7923,7779,1224,1046
2019년1분기,골목상권,디지털로37길,영등포구,대림2동,2116696,16367,2418,1443012,673699,1112372,1004323,7980,8387,1261,1157
2019년2분기,골목상권,디지털로37길,영등포구,대림2동,2483990,16367,3199,1663168,820831,1303579,1180414,7980,8387,1744,1455
2019년1분기,골목상권,곰달래로5길,양천구,신월1동,922522,24318,3869,649477,273044,491024,431509,12492,11826,2214,1655
2019년2분기,골목상권,곰달래로5길,양천구,신월1동,1248032,24318,2454,871434,376616,645322,602709,12492,11826,1339,1115
2019년1분기,골목상권,남부순환로33길,양천구,신월5동,753195,20825,3650,533190,220004,410885,342314,10518,10307,2102,1548
2019년2분기,골목상권,남부순환로33길,양천구,신월5동,1011878,20825,2498,709341,302555,545960,465922,10518,10307,1410,1088
2019년1분기,골목상권,남부순환로40길,양천구,신월3동,448870,15927,3235,322084,126792,244805,204067,8398,7529,2092,1143
2019년2분기,골목상권,남부순환로40길,양천구,신월3동,554400,15927,1611,390828,163583,291384,263022,8398,7529,1008,603
2019년1분기,골목상권,강서로18길,강서구,화곡8동,1974479,36071,1685,1385370,589112,932678,1041795,17436,18635,602,1083
2019년2분기,골목상권,강서로18길,강서구,화곡8동,2472192,36071,3425,1727348,744827,1154877,1317317,17436,18635,2172,1253
2019년1분기,골목상권,강서로29길,강서구,화곡1동,2061539,23622,3641,1469775,591774,1010124,1051413,11499,12123,1463,2178
2019년2분기,골목상권,강서로29길,강서구,화곡1동,2715293,23622,3094,1920438,794861,1322087,1393205,11499,12123,1432,1662
2019년1분기,골목상권,강서로35길,강서구,화곡3동,1794008,21859,2936,1260816,533196,869850,924158,10543,11316,1250,1686
2019년2분기,골목상권,강서로35길,강서구,화곡3동,2165075,21859,2484,1500632,664446,1032077,1133001,10543,11316,1296,1188
2019년1분기,골목상권,화곡로20길,강서구,화곡1동,1211116,25816,2982,837790,373337,623448,587668,12671,13145,1424,1558
2019년2분기,골목상권,화곡로20길,강서구,화곡1동,1767165,25816,2846,1215848,551327,909482,857687,12671,13145,1566,1280
2019년1분기,골목상권,화곡로31길,강서구,우장산동,2437856,26816,4101,1737550,700300,1172600,1265248,12946,13870,1584,2517
2019년2분기,골목상권,화곡로31길,강서구,우장산동,2925591,26816,4118,2067380,858207,1378636,1546944,12946,13870,2087,2031
2019년1분기,골목상권,화곡로44나길,강서구,화곡6동,1619411,18149,6307,1119513,499887,865703,753707,9072,9077,3720,2587
2019년2분기,골목상권,화곡로44나길,강서구,화곡6동,1892279,18149,6214,1297581,594708,988491,903795,9072,9077,3993,2221
2019년1분기,골목상권,디지털로57길,영등포구,대림2동,2232921,13994,2911,1521502,711440,1179100,1053817,6900,7094,1494,1417
2019년2분기,골목상권,디지털로57길,영등포구,대림2동,2556285,13994,3063,1702915,853378,1351016,1205275,6900,7094,1700,1363
2019년1분기,골목상권,디지털로74길,영등포구,대림1동,1211208,16891,2528,844478,366755,580338,630862,8417,8474,932,1596
2019년2분기,골목상권,디지털로74길,영등포구,대림1동,1498103,16891,3461,1038111,459991,710541,787546,8417,8474,1607,1854
2019년1분기,골목상권,선유로55길,영등포구,양평2동,883336,9218,30189,692209,191132,487334,396005,4591,4627,15693,14496
2019년2분기,골목상권,선유로55길,영등포구,양평2동,1089044,9218,11415,842936,246112,593648,495395,4591,4627,6048,5367
2019년1분기,골목상권,삼양로144길,도봉구,쌍문1동,491828,8261,1599,353753,138081,209932,281902,3933,4328,553,1046
2019년2분기,골목상권,삼양로144길,도봉구,쌍문1동,665542,8261,978,480906,184626,275906,389626,3933,4328,345,633
2019년1분기,골목상권,시루봉로23길,도봉구,도봉1동,479375,12967,3367,343632,135751,254317,225066,6700,6267,1869,1498
2019년2분기,골목상권,시루봉로23길,도봉구,도봉1동,609476,12967,1868,416166,193297,321230,288244,6700,6267,1322,546
2019년1분기,골목상권,우이천로32길,도봉구,쌍문1동,757448,17893,1811,533247,224200,359504,397947,8676,9217,781,1030
2019년2분기,골목상권,우이천로32길,도봉구,쌍문1동,927694,17893,1658,639281,288422,427301,500390,8676,9217,835,823
2019년1분기,골목상권,응암로34길,은평구,응암1동,2677456,21253,2396,1904256,773200,1275886,1401577,10292,10961,1029,1367
2019년2분기,골목상권,응암로34길,은평구,응암1동,2926650,21253,2199,2066621,860041,1401516,1525127,10292,10961,1270,929
2019년1분기,골목상권,증산로13길,은평구,증산동,1244734,18719,1878,859851,384886,649226,595500,9268,9451,935,943
2019년2분기,골목상권,증산로13길,은평구,증산동,1513692,18719,2236,1035355,478357,788177,725520,9268,9451,1592,644
2019년1분기,골목상권,증산로15길,은평구,신사2동,614418,17036,1752,429527,184897,325195,289224,8482,8554,902,850
2019년2분기,골목상권,증산로15길,은평구,신사2동,797046,17036,2125,550260,246801,425925,371135,8482,8554,1539,586
2019년1분기,골목상권,동교로27길,마포구,연남동,3008741,14574,13228,2096262,912476,1377872,1630858,6771,7803,6293,6935
2019년2분기,골목상권,동교로27길,마포구,연남동,3657280,14574,8492,2522162,1135125,1645876,2011396,6771,7803,4365,4127
2019년1분기,골목상권,동교로38길,마포구,연남동,2616882,12220,6660,1741084,875797,1137106,1479771,5800,6420,3556,3104
2019년2분기,골목상권,동교로38길,마포구,연남동,3192171,12220,4323,2097054,1095118,1372062,1820105,5800,6420,2241,2082
2019년1분기,골목상권,마포대로12길,마포구,아현동,2418603,14421,20035,1885105,533515,1261047,1157562,6760,7661,11048,8987
2019년2분기,골목상권,마포대로12길,마포구,아현동,2812430,14421,18846,2181865,630564,1448971,1363450,6760,7661,11355,7491
2019년1분기,골목상권,도봉로76길,강북구,미아동,2438315,16088,5726,1679916,758395,1239199,1199110,7805,8283,3093,2633
2019년2분기,골목상권,도봉로76길,강북구,미아동,2975403,16088,4033,2035022,940382,1477055,1498342,7805,8283,2370,1663
2019년1분기,골목상권,도봉로8길,강북구,송중동,1861047,6102,2864,1288799,572247,898070,962978,3062,3040,1160,1704
2019년2분기,골목상권,도봉로8길,강북구,송중동,2405916,6102,1074,1651840,754083,1114440,1291479,3062,3040,508,566
2019년1분기,골목상권,도봉로99길,강북구,수유3동,1336118,13042,2486,952091,384019,685890,650222,6527,6515,1084,1402
2019년2분기,골목상권,도봉로99길,강북구,수유3동,1605567,13042,1780,1126820,478766,800138,805429,6527,6515,819,961
2019년1분기,골목상권,우이천로4다길,도봉구,창3동,712413,20885,1549,502977,209441,359126,353285,10406,10479,772,777
2019년2분기,골목상권,우이천로4다길,도봉구,창3동,796669,20885,1386,545579,251082,396792,399873,10406,10479,783,603
2019년1분기,골목상권,해등로16길,도봉구,창5동,919489,23735,4681,658304,261191,466343,453138,11469,12266,2265,2416
2019년2분기,골목상권,해등로16길,도봉구,창5동,1182437,23735,5451,797196,385247,585743,596707,11469,12266,3248,2203
2019년1분기,골목상권,공릉로58길,노원구,하계1동,651028,8553,5242,492724,158290,340250,310772,4145,4408,2698,2544
2019년2분기,골목상권,공릉로58길,노원구,하계1동,767754,8553,3608,577186,190570,399646,368105,4145,4408,2361,1247
2019년1분기,골목상권,증산로17길,은평구,신사2동,936692,19598,2202,660526,276175,487369,449324,9645,9953,1064,1138
2019년2분기,골목상권,증산로17길,은평구,신사2동,1225859,19598,1725,852117,373752,640496,585373,9645,9953,1070,655
2019년1분기,골목상권,증산로21길,은평구,신사1동,2112277,29091,2315,1468694,643594,1077797,1034490,14169,14922,1028,1287
2019년2분기,골목상권,증산로21길,은평구,신사1동,2471148,29091,2744,1685532,785611,1231118,1240025,14169,14922,1530,1214
2019년1분기,골목상권,증산로5길,은평구,증산동,475097,12218,1473,332658,142448,244204,230884,6006,6212,781,692
2019년2분기,골목상권,증산로5길,은평구,증산동,579640,12218,2151,395873,183780,304367,275274,6006,6212,1437,714
2019년1분기,골목상권,마포대로20길,마포구,공덕동,2164726,19856,8436,1610060,554677,1076810,1087904,9487,10369,4406,4030
2019년2분기,골목상권,마포대로20길,마포구,공덕동,2444530,19856,7006,1815017,629528,1207111,1237419,9487,10369,3802,3204
2019년1분기,골목상권,마포대로4길,마포구,도화동,2498696,12794,18376,1964809,533888,1350337,1148367,6076,6718,10766,7610
2019년2분기,골목상권,마포대로4길,마포구,도화동,2973209,12794,14354,2282276,690929,1553940,1419269,6076,6718,9121,5233
2019년1분기,골목상권,만리재옛길,마포구,공덕동,2499727,20112,13649,1889736,609994,1253957,1245768,9588,10524,7519,6130
2019년2분기,골목상권,만리재옛길,마포구,공덕동,2884104,20112,11245,2173499,710610,1416555,1467549,9588,10524,7060,4185
2019년1분기,골목상권,삼각산로28길,강북구,수유3동,2962344,20112,6320,2070676,891684,1502500,1459842,9954,10158,3220,3100
2019년2분기,골목상권,삼각산로28길,강북구,수유3동,3406829,20112,4469,2350562,1056274,1691920,1714900,9954,10158,2212,2257
2019년1분기,골목상권,삼양로20길,강북구,송천동,1391250,19079,1114,987448,403797,666191,725057,9469,9610,440,674
2019년2분기,골목상권,삼양로20길,강북구,송천동,1720920,19079,1218,1189708,531212,803366,917549,9469,9610,717,501
2019년1분기,골목상권,삼양로24길,강북구,송천동,1640987,21332,1806,1165661,475321,781138,859838,10591,10741,839,967
2019년2분기,골목상권,삼양로24길,강북구,송천동,1994890,21332,1200,1397517,597381,935182,1059706,10591,10741,743,457
2019년1분기,골목상권,동일로173가길,노원구,공릉1동,2592428,19291,8070,1849761,742674,1329721,1262702,9496,9795,4082,3988
2019년2분기,골목상권,동일로173가길,노원구,공릉1동,3051538,19291,5204,2142606,908949,1530097,1521437,9496,9795,2897,2307
2019년1분기,골목상권,동일로192길,노원구,공릉1동,3874470,26390,5554,2748691,1125791,2059716,1814749,13340,13050,3162,2392
2019년2분기,골목상권,동일로192길,노원구,공릉1동,4453158,26390,3680,3121489,1331695,2305617,2147535,13340,13050,2246,1434
2019년1분기,골목상권,동일로242길,노원구,상계1동,749549,11698,3250,513184,236366,386573,362983,5688,6010,1937,1313
2019년2분기,골목상권,동일로242길,노원구,상계1동,938899,11698,2117,633477,305423,470827,468078,5688,6010,1222,895
2019년1분기,골목상권,증산로9길,은평구,증산동,478068,15039,1371,329281,148795,247933,230123,7374,7665,740,631
2019년2분기,골목상권,증산로9길,은평구,증산동,597851,15039,2208,405521,192344,311698,286154,7374,7665,1527,681
2019년1분기,골목상권,증산서길,은평구,증산동,665257,13420,2846,476915,188358,348512,316740,6627,6793,1634,1212
2019년2분기,골목상권,증산서길,은평구,증산동,804267,13420,4701,565958,238311,421458,382811,6627,6793,3376,1325
2019년1분기,골목상권,진흥로12길,은평구,녹번동,2531465,27046,5253,1791614,739858,1241911,1289545,13020,14026,2218,3035
2019년2분기,골목상권,진흥로12길,은평구,녹번동,2962104,27046,3073,2077190,884915,1431990,1530114,13020,14026,1429,1644
2019년1분기,골목상권,망원로11길,마포구,망원2동,1797896,19633,6720,1269503,528408,864846,933056,9216,10417,3775,2945
2019년2분기,골목상권,망원로11길,마포구,망원2동,2121312,19633,8279,1484761,636548,1004843,1116471,9216,10417,5674,2605
2019년1분기,골목상권,망원로2길,마포구,망원1동,1743120,25329,2820,1179638,563475,843200,899920,12127,13202,1480,1340
2019년2분기,골목상권,망원로2길,마포구,망원1동,2191240,25329,3832,1447094,744164,1026789,1164454,12127,13202,2116,1716
2019년1분기,골목상권,매봉산로2길,마포구,상암동,785642,8491,17750,634086,151560,444483,341155,4169,4322,9941,7809
2019년2분기,골목상권,매봉산로2길,마포구,상암동,1014785,8491,8179,800739,214058,554719,460067,4169,4322,5297,2882
2019년1분기,골목상권,삼양로27길,강북구,삼각산동,1891998,24896,1707,1328097,563901,919652,972337,12047,12849,602,1105
2019년2분기,골목상권,삼양로27길,강북구,삼각산동,2257286,24896,1290,1557826,699465,1077872,1179422,12047,12849,701,589
2019년1분기,골목상권,삼양로41길,강북구,삼양동,2481420,24642,2162,1736777,744650,1236114,1245295,12118,12524,849,1313
2019년2분기,골목상권,삼양로41길,강북구,삼양동,3039616,24642,1150,2097828,941807,1477470,1562148,12118,12524,613,537
2019년1분기,골목상권,삼양로54길,강북구,송천동,1415743,20139,1522,988780,426994,710484,705268,9953,10186,653,869
2019년2분기,골목상권,삼양로54길,강북구,송천동,1752347,20139,1275,1208597,543768,840263,912082,9953,10186,597,678
2019년1분기,골목상권,상계로12길,노원구,상계2동,2419221,31119,3410,1679061,740171,1189401,1229833,15167,15952,1385,2025
2019년2분기,골목상권,상계로12길,노원구,상계2동,2826388,31119,2673,1931790,894613,1340090,1486294,15167,15952,1308,1365
2019년1분기,골목상권,상계로1길,노원구,상계2동,2633125,12688,3131,1822638,810479,1288687,1344438,5982,6706,1164,1967
2019년2분기,골목상권,상계로1길,노원구,상계2동,3009133,12688,1542,2044696,964442,1434954,1574178,5982,6706,721,821
2019년1분기,골목상권,상계로9가길,노원구,상계2동,2601704,22903,3297,1830175,771539,1307522,1294195,11206,11697,1204,2093
2019년2분기,골목상권,상계로9가길,노원구,상계2동,3032268,22903,1901,2108529,923736,1476311,1555947,11206,11697,852,1049
2019년1분기,골목상권,진흥로1길,은평구,역촌동,2327464,27936,3828,1625325,702168,1097720,1229755,13202,14734,1866,1962
2019년2분기,골목상권,진흥로1길,은평구,역촌동,3599688,27936,3044,2521336,1078342,1661501,1938179,13202,14734,1508,1536
2019년1분기,골목상권,통일로69길,은평구,대조동,2182788,16239,2391,1529680,653103,1047416,1135368,7763,8476,912,1479
2019년2분기,골목상권,통일로69길,은평구,대조동,2741533,16239,1497,1904084,837440,1282589,1458950,7763,8476,762,735
2019년1분기,골목상권,통일로78길,은평구,불광2동,1458266,21264,2128,1037058,421207,703391,754877,10092,11172,853,1275
2019년2분기,골목상권,통일로78길,은평구,불광2동,1374885,21264,3522,966054,408835,655263,719627,10092,11172,1708,1814
2019년1분기,골목상권,모래내로7길,마포구,성산2동,906119,15415,3546,651627,254486,443274,462842,7509,7906,2261,1285
2019년2분기,골목상권,모래내로7길,마포구,성산2동,1130976,15415,1979,797214,333775,554452,576522,7509,7906,1273,706
2019년1분기,골목상권,방울내로9안길,마포구,망원2동,1443671,20225,4032,1009428,434242,699921,743744,9549,10676,2245,1787
2019년2분기,골목상권,방울내로9안길,마포구,망원2동,1706543,20225,3140,1169578,536974,816134,890422,9549,10676,1769,1371
2019년1분기,골목상권,백범로16길,마포구,대흥동,2190599,19161,16851,1695113,495494,1169875,1020726,9313,9848,10466,6385
2019년2분기,골목상권,백범로16길,마포구,대흥동,2782323,19161,30848,2149497,632840,1447199,1335134,9313,9848,17676,13172
2019년1분기,골목상권,삼양로77길,강북구,수유1동,947177,20964,1442,673832,273349,465002,482178,10426,10538,503,939
2019년2분기,골목상권,삼양로77길,강북구,수유1동,1185660,20964,1393,823592,362078,583147,602516,10426,10538,588,805
2019년1분기,골목상권,삼양로93길,강북구,인수동,1266273,23141,2326,894921,371374,602284,663992,11351,11790,1006,1320
2019년2분기,골목상권,삼양로93길,강북구,인수동,1472659,23141,2200,1023035,449631,695555,777098,11351,11790,1067,1133
2019년1분기,골목상권,솔매로41길,강북구,미아동,1713624,19791,2274,1216989,496655,848757,864876,9731,10060,1040,1234
2019년2분기,골목상권,솔매로41길,강북구,미아동,2146393,19791,1672,1497811,648603,1023903,1122492,9731,10060,942,730
2019년1분기,골목상권,석계로1길,노원구,월계1동,1373892,16177,2119,1002713,371191,771438,602448,8176,8001,1100,1019
2019년2분기,골목상권,석계로1길,노원구,월계1동,1472430,16177,1861,1074586,397859,832605,639823,8176,8001,921,940
2019년1분기,골목상권,한글비석로22길,노원구,중계4동,1614632,19374,2498,1142551,472095,835079,779557,9327,10047,941,1557
2019년2분기,골목상권,한글비석로22길,노원구,중계4동,1907016,19374,2019,1329909,577118,958639,948377,9327,10047,1110,909
2019년1분기,골목상권,한글비석로24길,노원구,상계5동,2012532,22478,2538,1413866,598683,1044985,967550,10976,11502,1140,1398
2019년2분기,골목상권,한글비석로24길,노원구,상계5동,2383086,22478,1494,1649348,733753,1193994,1189092,10976,11502,778,716
2019년1분기,골목상권,통일로87길,은평구,갈현1동,1825643,20311,2025,1281459,544182,892061,933578,9845,10466,868,1157
2019년2분기,골목상권,통일로87길,은평구,갈현1동,2256743,20311,1913,1559886,696857,1087331,1169414,9845,10466,875,1038
2019년1분기,골목상권,통일로92길,은평구,불광2동,1594691,22413,2300,1126124,468568,788474,806205,10950,11463,1049,1251
2019년2분기,골목상권,통일로92길,은평구,불광2동,1749148,22413,2025,1214344,534808,865320,883829,10950,11463,859,1166
2019년1분기,골목상권,가재울로6길,서대문구,남가좌2동,1502944,24716,1546,1091022,411937,761544,741402,11933,12783,819,727
2019년2분기,골목상권,가재울로6길,서대문구,남가좌2동,1883404,24716,838,1380292,503125,947748,935660,11933,12783,438,400
2019년1분기,골목상권,숭문길,마포구,염리동,1510022,12142,11314,1173382,336632,790471,719556,5863,6279,7256,4058
2019년2분기,골목상권,숭문길,마포구,염리동,1970205,12142,22147,1533374,436838,1001359,968853,5863,6279,12344,9803
2019년1분기,골목상권,신촌로12길,마포구,서교동,3907058,11888,9488,2702421,1204635,1758959,2148108,5783,6105,4764,4724
2019년2분기,골목상권,신촌로12길,마포구,서교동,4577855,11888,2882,3126357,1451501,2028547,2549304,5783,6105,1317,1565
2019년1분기,골목상권,신촌로28가길,마포구,아현동,1567184,12136,1065,1139572,427612,678318,888866,5747,6389,385,680
2019년2분기,골목상권,신촌로28가길,마포구,아현동,1861713,12136,810,1350796,510917,812739,1048970,5747,6389,316,494
2019년1분기,골목상권,솔매로45길,강북구,미아동,1423310,14169,2636,1020203,403109,684592,738715,6949,7220,1203,1433
2019년2분기,골목상권,솔매로45길,강북구,미아동,1836931,14169,1533,1300569,536365,841360,995573,6949,7220,906,627
2019년1분기,골목상권,솔매로50길,강북구,송중동,2377521,19872,3844,1702452,675074,1106903,1270617,9755,10117,1621,2223
2019년2분기,골목상권,솔매로50길,강북구,송중동,3164103,19872,2202,2236600,927517,1440448,1723657,9755,10117,1182,1020
2019년1분기,골목상권,솔샘로65길,강북구,송천동,1601197,17744,3095,1142010,459183,731817,869379,8712,9032,1422,1673
2019년2분기,골목상권,솔샘로65길,강북구,송천동,2057530,17744,1789,1464746,592793,935296,1122228,8712,9032,813,976
2019년1분기,골목상권,한글비석로44길,노원구,상계5동,1371641,22834,2289,959473,412173,708945,662699,11293,11541,1158,1131
2019년2분기,골목상권,한글비석로44길,노원구,상계5동,1667851,22834,1688,1147285,520559,830496,837352,11293,11541,908,780
2019년1분기,골목상권,가좌로7길,은평구,응암3동,2561223,26855,2464,1829001,732224,1304429,1256798,13396,13459,1265,1199
2019년2분기,골목상권,가좌로7길,은평구,응암3동,3024137,26855,2162,2151030,873121,1522788,1501342,13396,13459,1118,1044
2019년1분기,골목상권,갈현로1길,은평구,신사1동,972046,25004,1905,677694,294354,495789,476255,12209,12795,773,1132
2019년2분기,골목상권,갈현로1길,은평구,신사1동,1090804,25004,1978,742745,348055,540944,549863,12209,12795,1035,943
2019년1분기,골목상권,독립문로8길,서대문구,천연동,1845095,23786,3344,1386223,458887,951323,893774,11427,12359,1644,1700
2019년2분기,골목상권,독립문로8길,서대문구,천연동,2277028,23786,4893,1691748,585288,1128591,1148430,11427,12359,2970,1923
2019년1분기,골목상권,명지대길,서대문구,남가좌2동,1541892,18422,2438,1163507,378380,778572,763323,9014,9408,1275,1163
2019년2분기,골목상권,명지대길,서대문구,남가좌2동,2024744,18422,2332,1560943,463812,1000046,1024691,9014,9408,1380,952
2019년1분기,골목상권,모래내로15길,서대문구,남가좌1동,1171251,33777,2144,841958,329303,577996,593261,16337,17440,1047,1097
2019년2분기,골목상권,모래내로15길,서대문구,남가좌1동,1400764,33777,7538,993493,407277,687459,713295,16337,17440,4040,3498
2019년1분기,골목상권,성미산로11길,마포구,성산1동,1407240,15912,6590,1010736,396515,679266,727963,7525,8387,4122,2468
2019년2분기,골목상권,성미산로11길,마포구,성산1동,1730222,15912,4101,1232222,498007,834970,895259,7525,8387,2672,1429
2019년1분기,골목상권,성미산로1길,마포구,성산1동,1700088,19101,7594,1209452,490642,814607,885486,9030,10071,4150,3444
2019년2분기,골목상권,성미산로1길,마포구,성산1동,2041834,19101,8621,1441993,599843,966875,1074961,9030,10071,5871,2750
2019년1분기,골목상권,성미산로32길,마포구,연남동,2038893,11108,3803,1334999,703888,880965,1157922,5203,5905,2062,1741
2019년2분기,골목상권,성미산로32길,마포구,연남동,2520923,11108,2456,1627030,893906,1081079,1439840,5203,5905,1437,1019
2019년1분기,골목상권,수유로12길,강북구,수유1동,2376827,17647,5147,1673539,703292,1196733,1180094,8638,9009,2380,2767
2019년2분기,골목상권,수유로12길,강북구,수유1동,2823843,17647,3033,1962918,860939,1399347,1424492,8638,9009,1495,1538
2019년1분기,골목상권,오패산로30길,강북구,송중동,1319245,17238,1465,932949,386293,639700,679539,8169,9069,634,831
2019년2분기,골목상권,오패산로30길,강북구,송중동,1644810,17238,1172,1160634,484167,764523,880287,8169,9069,535,637
2019년1분기,골목상권,오패산로52길,강북구,송중동,1174419,18019,1088,835048,339379,570877,603539,8831,9188,430,658
2019년2분기,골목상권,오패산로52길,강북구,송중동,1530916,18019,1556,1067200,463724,730715,800200,8831,9188,878,678
2019년1분기,골목상권,갈현로33길,은평구,갈현2동,1258292,22156,1585,890515,367798,587844,670445,10689,11467,632,953
2019년2분기,골목상권,갈현로33길,은평구,갈현2동,1621208,22156,1575,1134512,486701,754059,867146,10689,11467,733,842
2019년1분기,골목상권,갈현로41길,은평구,갈현1동,1034498,21049,898,717988,316523,512085,522426,10241,10808,420,478
2019년2분기,골목상권,갈현로41길,은평구,갈현1동,1333905,21049,1406,909165,424737,648642,685263,10241,10808,776,630
2019년1분기,골목상권,갈현로7길,은평구,역촌동,1574539,26682,2720,1114594,459930,754286,820245,13424,13258,1020,1700
2019년2분기,골목상권,갈현로7길,은평구,역촌동,1815710,26682,2412,1264170,551542,859882,955828,13424,13258,1048,1364
2019년1분기,골목상권,북아현로4길,서대문구,북아현동,7673090,15893,7975,6199975,1473134,4038509,3634580,7872,8021,4956,3019
2019년2분기,골목상권,북아현로4길,서대문구,북아현동,8775610,15893,4260,6954005,1821597,4507204,4268400,7872,8021,2491,1769
2019년1분기,골목상권,세검정로1길,서대문구,홍은1동,1856030,14634,2205,1323448,532586,906637,949400,6967,7667,876,1329
2019년2분기,골목상권,세검정로1길,서대문구,홍은1동,2050199,14634,1807,1446201,604018,999521,1050681,6967,7667,817,990
2019년1분기,골목상권,세무서2길,서대문구,홍제2동,1394021,17734,2195,998646,395367,648763,745261,8534,9200,813,1382
2019년2분기,골목상권,세무서2길,서대문구,홍제2동,1614094,17734,2073,1145747,468361,757987,856109,8534,9200,1021,1052
2019년1분기,골목상권,성산로4길,마포구,성산1동,1323768,21789,8114,946686,377093,645698,678066,9912,11877,3885,4229
2019년2분기,골목상권,성산로4길,마포구,성산1동,1609462,21789,4782,1139040,470407,778479,830986,9912,11877,2818,1964
2019년1분기,골목상권,성지3길,마포구,합정동,1709330,8178,6176,1195505,513835,856091,853239,3826,4352,3478,2698
2019년2분기,골목상권,성지3길,마포구,합정동,2229375,8178,4035,1541632,687738,1090375,1138999,3826,4352,2368,1667
2019년1분기,골목상권,숭문8길,마포구,염리동,1111974,12904,6219,847290,264679,572339,539641,6299,6605,4024,2195
2019년2분기,골목상권,숭문8길,마포구,염리동,1351074,12904,3737,1033438,317639,681393,669676,6299,6605,2438,1299
2019년1분기,골목상권,오패산로67길,강북구,번1동,3574696,16567,5765,2480624,1094076,1817748,1756946,8112,8455,3062,2703
2019년2분기,골목상권,오패산로67길,강북구,번1동,4171537,16567,3440,2857626,1313910,2088254,2083275,8112,8455,1912,1528
2019년1분기,골목상권,인수봉로56길,강북구,인수동,1072565,18140,2547,755012,317566,521444,551128,8886,9254,1297,1250
2019년2분기,골목상권,인수봉로56길,강북구,인수동,1241814,18140,2117,853978,387836,593687,648116,8886,9254,1267,850
2019년1분기,골목상권,인수봉로72길,강북구,인수동,1132440,21597,2235,804683,327774,535539,596908,10614,10983,873,1362
2019년2분기,골목상권,인수봉로72길,강북구,인수동,1353891,21597,3703,946862,407034,646539,707358,10614,10983,2182,1521
2019년1분기,골목상권,불광천길,은평구,응암3동,2810470,22160,2324,1980565,829920,1400962,1409512,10711,11449,1044,1280
2019년2분기,골목상권,불광천길,은평구,응암3동,3248817,22160,1888,2257417,991393,1610236,1638577,10711,11449,1026,862
2019년1분기,골목상권,서오릉로21길,은평구,구산동,844090,19896,2364,585084,258994,407121,436968,9765,10131,1441,923
2019년2분기,골목상권,서오릉로21길,은평구,구산동,1037594,19896,3298,704646,332961,509280,528310,9765,10131,2031,1267
2019년1분기,골목상권,서오릉로8길,은평구,대조동,1742904,25344,2059,1207910,534997,854008,888896,12242,13102,871,1188
2019년2분기,골목상권,서오릉로8길,은평구,대조동,2167829,25344,2131,1491784,676052,1042365,1125467,12242,13102,1174,957
2019년1분기,골목상권,세무서길,서대문구,홍제3동,1991337,18550,2353,1433311,558027,938237,1053106,9004,9546,891,1462
2019년2분기,골목상권,세무서길,서대문구,홍제3동,2248534,18550,2079,1609060,639500,1070701,1177835,9004,9546,981,1098
2019년1분기,골목상권,수색로8길,서대문구,북가좌1동,860849,15998,3128,605573,255287,421413,439440,7779,8219,2132,996
2019년2분기,골목상권,수색로8길,서대문구,북가좌1동,1032253,15998,3693,712051,320205,499242,533015,7779,8219,2936,757
2019년1분기,골목상권,신촌로37길,서대문구,북아현동,7591396,13639,7562,6103208,1488187,3958952,3632443,6698,6941,4672,2890
2019년2분기,골목상권,신촌로37길,서대문구,북아현동,8637189,13639,3718,6876457,1760717,4416329,4220857,6698,6941,2170,1548
2019년1분기,골목상권,정릉로26길,성북구,정릉2동,724646,16191,1283,506720,217918,355940,368709,7901,8290,541,742
2019년2분기,골목상권,정릉로26길,성북구,정릉2동,864738,16191,3569,588376,276368,423492,441250,7901,8290,1878,1691
2019년1분기,골목상권,정릉로27길,성북구,정릉2동,1675001,27372,2215,1177832,497155,817396,857601,13358,14014,1060,1155
2019년2분기,골목상권,정릉로27길,성북구,정릉2동,1978118,27372,4760,1362870,615251,974350,1003777,13358,14014,2515,2245
2019년1분기,골목상권,정릉로8길,성북구,정릉3동,185699,4616,2471,144439,41255,107513,78187,2411,2205,1516,955
2019년2분기,골목상권,정릉로8길,성북구,정릉3동,246743,4616,1863,191975,54781,144899,101846,2411,2205,1360,503
2019년1분기,골목상권,인수봉로79길,강북구,인수동,453698,14685,2164,320558,133143,206136,247557,7160,7525,973,1191
2019년2분기,골목상권,인수봉로79길,강북구,인수동,587535,14685,2295,404469,183070,272499,315039,7160,7525,1214,1081
2019년1분기,골목상권,한천로109길,강북구,번3동,710345,23599,2011,501340,209007,348788,361564,11300,12299,978,1033
2019년2분기,골목상권,한천로109길,강북구,번3동,890722,23599,1729,610686,280035,426074,464652,11300,12299,864,865
2019년1분기,골목상권,한천로124나길,강북구,번1동,1858926,16243,2922,1322128,536784,936764,922165,8136,8107,1580,1342
2019년2분기,골목상권,한천로124나길,강북구,번1동,2197662,16243,1736,1540623,657030,1096516,1101143,8136,8107,1053,683
2019년1분기,골목상권,수색로18길,은평구,수색동,549109,4120,1468,409799,139326,326247,222863,2083,2037,751,717
2019년2분기,골목상권,수색로18길,은평구,수색동,552355,4120,709,406236,146123,318370,233987,2083,2037,448,261
2019년1분기,골목상권,역말로9길,은평구,대조동,1954611,27151,2285,1400764,553835,887878,1066734,12891,14260,905,1380
2019년2분기,골목상권,역말로9길,은평구,대조동,2604659,27151,2449,1849051,755598,1132698,1471959,12891,14260,1165,1284
2019년1분기,골목상권,연서로11길,은평구,구산동,1385909,23989,1791,976701,409212,640677,745233,11415,12574,751,1040
2019년2분기,골목상권,연서로11길,은평구,구산동,2170562,23989,2557,1524617,645954,977223,1193332,11415,12574,1359,1198
2019년1분기,골목상권,연희로10길,서대문구,연희동,1169319,11601,14872,832551,336777,562068,607246,5799,5802,5908,8964
2019년2분기,골목상권,연희로10길,서대문구,연희동,1248659,11601,7240,884829,363841,586611,662046,5799,5802,5475,1765
2019년1분기,골목상권,응암로1길,서대문구,북가좌2동,1694419,20795,2762,1189611,504803,858193,836217,10152,10643,1312,1450
2019년2분기,골목상권,응암로1길,서대문구,북가좌2동,2063359,20795,3214,1428792,634561,1024491,1038858,10152,10643,1736,1478
2019년1분기,골목상권,증가로10길,서대문구,남가좌2동,1776553,16415,1927,1312858,463704,903613,872938,8026,8389,893,1034
2019년2분기,골목상권,증가로10길,서대문구,남가좌2동,2321868,16415,1956,1744055,577821,1158844,1163031,8026,8389,1073,883
2019년1분기,골목상권,종암로16길,성북구,종암동,1189414,22273,1923,861159,328250,591453,597961,10988,11285,748,1175
2019년2분기,골목상권,종암로16길,성북구,종암동,1404490,22273,1720,1004613,399886,697806,706690,10988,11285,734,986
2019년1분기,골목상권,종암로19길,성북구,종암동,1033088,18309,1605,734561,298516,500577,532508,8870,9439,581,1024
2019년2분기,골목상권,종암로19길,성북구,종암동,1183053,18309,3386,825301,357763,579972,603077,8870,9439,1915,1471
2019년1분기,골목상권,종암로21길,성북구,종암동,1066724,17520,2678,759021,307714,526446,540280,8438,9082,1365,1313
2019년2분기,골목상권,종암로21길,성북구,종암동,1294793,17520,5276,909793,385012,627677,667113,8438,9082,3322,1954
2019년1분기,골목상권,한천로130길,강북구,번1동,1658070,19336,2136,1176576,481489,844820,813257,9674,9662,973,1163
2019년2분기,골목상권,한천로130길,강북구,번1동,1957100,19336,1195,1365479,591614,986430,970671,9674,9662,629,566
2019년1분기,골목상권,한천로132길,강북구,번1동,2988756,18742,5259,2125804,862950,1493582,1495177,9330,9412,2693,2566
2019년2분기,골목상권,한천로132길,강북구,번1동,3500835,18742,4071,2456145,1044685,1726685,1774146,9330,9412,2362,1709
2019년1분기,골목상권,한천로139가길,강북구,수유3동,3046151,12681,4968,2138630,907521,1540400,1505749,6286,6395,2487,2481
2019년2분기,골목상권,한천로139가길,강북구,수유3동,3503989,12681,3248,2432786,1071210,1732786,1771210,6286,6395,1550,1698
2019년1분기,골목상권,연서로13길,은평구,구산동,1800499,26779,4175,1296090,504418,820781,979718,12767,14012,2025,2150
2019년2분기,골목상권,연서로13길,은평구,구산동,2194847,26779,4641,1557143,637714,968077,1226760,12767,14012,2422,2219
2019년1분기,골목상권,연서로16길,은평구,역촌동,2370544,27667,3407,1701508,669042,1112266,1258283,13066,14601,1345,2062
2019년2분기,골목상권,연서로16길,은평구,역촌동,3238019,27667,3829,2300853,937174,1448495,1789509,13066,14601,1564,2265
2019년1분기,골목상권,연서로17길,은평구,갈현2동,2097996,22608,4227,1502108,595897,973414,1124583,10681,11927,1925,2302
2019년2분기,골목상권,연서로17길,은평구,갈현2동,2450829,22608,4721,1722663,728175,1106100,1344723,10681,11927,2438,2283
2019년1분기,골목상권,증가로20가길,서대문구,북가좌2동,1611992,23497,1276,1180332,431670,811939,800054,11592,11905,495,781
2019년2분기,골목상권,증가로20가길,서대문구,북가좌2동,1890555,23497,4286,1394194,496366,935606,954941,11592,11905,2026,2260
2019년1분기,골목상권,증가로23나길,서대문구,북가좌2동,2518780,33028,2934,1776902,741882,1257378,1261396,16047,16981,1333,1601
2019년2분기,골목상권,증가로23나길,서대문구,북가좌2동,2958933,33028,5873,2055971,902975,1433237,1525690,16047,16981,2859,3014
2019년1분기,골목상권,증가로6길,서대문구,홍은2동,1753603,16402,1991,1264117,489485,880960,872640,8019,8383,1067,924
2019년2분기,골목상권,증가로6길,서대문구,홍은2동,2223067,16402,1829,1615799,607278,1102127,1120945,8019,8383,1117,712
2019년1분기,골목상권,종암로24가길,성북구,종암동,827327,17884,2393,594980,232350,409706,417626,8723,9161,1261,1132
2019년2분기,골목상권,종암로24가길,성북구,종암동,971516,17884,1983,690475,281051,479704,491814,8723,9161,1142,841
2019년1분기,골목상권,종암로5길,성북구,종암동,818817,9672,4981,614185,204629,412826,405992,4951,4721,2784,2197
2019년2분기,골목상권,종암로5길,성북구,종암동,1073576,9672,997,807616,265969,545017,528559,4951,4721,530,467
2019년1분기,골목상권,지봉로20길,성북구,보문동,1343948,18325,3415,972303,371642,680066,663874,8932,9393,1841,1574
2019년2분기,골목상권,지봉로20길,성북구,보문동,1582741,18325,7066,1127836,454909,804651,778094,8932,9393,5312,1754
2019년1분기,골목상권,한천로140길,강북구,수유3동,2012629,15506,4166,1429608,583008,1023614,989014,7753,7753,2026,2140
2019년2분기,골목상권,한천로140길,강북구,수유3동,2383029,15506,3505,1670378,712661,1192701,1190332,7753,7753,1838,1667
2019년1분기,골목상권,노해로60길,도봉구,쌍문3동,2562168,20063,2895,1834106,728052,1197104,1365077,9626,10437,1380,1515
2019년2분기,골목상권,노해로60길,도봉구,쌍문3동,3207003,20063,1863,2216393,990622,1500805,1706202,9626,10437,1088,775
2019년1분기,골목상권,노해로63다길,도봉구,창5동,492502,16875,3882,350003,142502,246733,245767,8183,8692,1946,1936
2019년2분기,골목상권,노해로63다길,도봉구,창5동,617478,16875,5116,427382,190097,302101,315382,8183,8692,3100,2016
2019년1분기,골목상권,연서로21길,은평구,갈현2동,2104267,25155,4240,1490246,614034,989012,1115256,11926,13229,2004,2236
2019년2분기,골목상권,연서로21길,은평구,갈현2동,2492922,25155,4422,1733616,759320,1144116,1348806,11926,13229,2282,2140
2019년1분기,골목상권,연서로27길,은평구,갈현2동,5507224,23204,3472,3884880,1622356,2682647,2824574,11014,12190,1316,2156
2019년2분기,골목상권,연서로27길,은평구,갈현2동,6633701,23204,2345,4619639,2014072,3148966,3484740,11014,12190,1036,1309
2019년1분기,골목상권,연서로28길,은평구,대조동,5052981,21731,3929,3575080,1477890,2484208,2568778,10250,11481,1484,2445
2019년2분기,골목상권,연서로28길,은평구,대조동,6121125,21731,2456,4283224,1837898,2909675,3211456,10250,11481,1054,1402
2019년1분기,골목상권,충정로4길,서대문구,충현동,6892360,11640,22633,5590078,1302283,3664270,3228094,5760,5880,13565,9068
2019년2분기,골목상권,충정로4길,서대문구,충현동,7445610,11640,12451,6034010,1411600,3876476,3569129,5760,5880,7547,4904
2019년1분기,골목상권,충정로6길,서대문구,충현동,2547737,5433,59195,2144747,402992,1430196,1117548,2652,2781,33776,25419
2019년2분기,골목상권,충정로6길,서대문구,충현동,2877009,5433,22356,2419060,457964,1577341,1299672,2652,2781,13551,8805
2019년1분기,골목상권,통일로11길,서대문구,천연동,936504,9823,1390,686344,250165,455599,480910,4653,5170,631,759
2019년2분기,골목상권,통일로11길,서대문구,천연동,1114742,9823,1905,805769,308981,532986,581752,4653,5170,1117,788
2019년1분기,골목상권,창경궁로43길,성북구,성북동,1215472,10927,3313,868365,347113,570927,644542,5122,5805,1562,1751
2019년2분기,골목상권,창경궁로43길,성북구,성북동,1524789,10927,4349,1075570,449226,714501,810284,5122,5805,2296,2053
2019년1분기,골목상권,한천로101가길,성북구,장위1동,540117,11771,1300,395460,144666,296829,243293,5785,5986,565,735
2019년2분기,골목상권,한천로101가길,성북구,장위1동,807265,11771,830,576712,230566,445635,361633,5785,5986,373,457
2019년1분기,골목상권,한천로76길,성북구,석관동,1444707,14585,2008,1032405,412315,777236,667465,7354,7231,1052,956
2019년2분기,골목상권,한천로76길,성북구,석관동,1617568,14585,1346,1139428,478149,842769,774802,7354,7231,868,478
2019년1분기,골목상권,덕릉로60길,도봉구,창3동,688588,20436,1361,483792,204806,343458,345127,10152,10284,586,775
2019년2분기,골목상권,덕릉로60길,도봉구,창3동,775600,20436,1096,530178,245415,380413,395182,10152,10284,618,478
2019년1분기,골목상권,도당로13가길,도봉구,방학2동,1232758,21133,1155,863228,369538,661959,570813,10714,10419,497,658
2019년2분기,골목상권,도당로13가길,도봉구,방학2동,1443799,21133,766,991563,452238,765541,678265,10714,10419,411,355
2019년1분기,골목상권,도당로13바길,도봉구,방학2동,1068967,21538,1296,748945,320027,562872,506109,10954,10584,550,746
2019년2분기,골목상권,도당로13바길,도봉구,방학2동,1275335,21538,1012,873703,401621,664534,610801,10954,10584,480,532
2019년1분기,골목상권,연서로29길,은평구,갈현1동,3745582,14725,2881,2639289,1106301,1827194,1918383,7029,7696,1090,1791
2019년2분기,골목상권,연서로29길,은평구,갈현1동,4549749,14725,2127,3171490,1378262,2172305,2377444,7029,7696,845,1282
2019년1분기,골목상권,연서로33길,은평구,불광2동,1338273,19367,1742,950621,387657,646225,692047,9344,10023,674,1068
2019년2분기,골목상권,연서로33길,은평구,불광2동,1148242,19367,2746,802956,345286,562181,586059,9344,10023,1316,1430
2019년1분기,골목상권,연서로34길,은평구,불광2동,1326989,20785,1417,932314,394683,657577,669414,10039,10746,476,941
2019년2분기,골목상권,연서로34길,은평구,불광2동,1219386,20785,2572,836703,382686,607862,611523,10039,10746,1211,1361
2019년1분기,골목상권,통일로37길,서대문구,홍제1동,1908845,13685,2084,1373353,535506,904964,1003888,6521,7164,773,1311
2019년2분기,골목상권,통일로37길,서대문구,홍제1동,2246286,13685,1937,1600811,645485,1058524,1187765,6521,7164,969,968
2019년1분기,골목상권,통일로39길,서대문구,홍제1동,1793213,11600,2092,1297008,496211,850249,942976,5515,6085,762,1330
2019년2분기,골목상권,통일로39길,서대문구,홍제1동,2119438,11600,1847,1519879,599560,995311,1124124,5515,6085,875,972
2019년1분기,골목상권,홍연길,서대문구,연희동,987077,11253,1461,689783,297301,480802,506272,5430,5823,789,672
2019년2분기,골목상권,홍연길,서대문구,연희동,1175794,11253,1345,810621,365189,575176,600626,5430,5823,854,491
2019년1분기,골목상권,화랑로13길,성북구,월곡2동,1634815,16700,5057,1174121,460678,746507,888310,7921,8779,2819,2238
2019년2분기,골목상권,화랑로13길,성북구,월곡2동,1930138,16700,3161,1395096,535046,839026,1091106,7921,8779,2021,1140
2019년1분기,골목상권,화랑로14길,성북구,월곡2동,1399801,12598,4281,1012494,387304,644404,755400,6126,6472,2397,1884
2019년2분기,골목상권,화랑로14길,성북구,월곡2동,1640441,12598,3175,1190561,449889,717297,923145,6126,6472,1904,1271
2019년1분기,골목상권,화랑로19길,성북구,장위2동,1174206,17515,1967,852174,322046,578796,595414,8727,8788,978,989
2019년2분기,골목상권,화랑로19길,성북구,장위2동,1413447,17515,2256,1006063,407385,690459,722997,8727,8788,1314,942
2019년1분기,골목상권,도당로19길,도봉구,방학1동,861893,21181,1087,608974,252932,458028,403871,10820,10361,507,580
2019년2분기,골목상권,도당로19길,도봉구,방학1동,1023179,21181,782,694788,328393,550050,473135,10820,10361,421,361
2019년1분기,골목상권,도당로29길,도봉구,방학1동,900945,18736,3176,643807,257152,469963,430992,9564,9172,1657,1519
2019년2분기,골목상권,도당로29길,도봉구,방학1동,1084429,18736,2453,746436,337994,570018,514417,9564,9172,1779,674
2019년1분기,골목상권,도봉로109길,도봉구,쌍문3동,2107648,22031,3434,1512577,595061,1007681,1099972,10628,11403,1534,1900
2019년2분기,골목상권,도봉로109길,도봉구,쌍문3동,2644749,22031,3014,1837022,807736,1255020,1389730,10628,11403,1582,1432
2019년1분기,골목상권,연서로3길,은평구,역촌동,1491828,24944,2221,1050167,441651,727687,764138,11885,13059,1040,1181
2019년2분기,골목상권,연서로3길,은평구,역촌동,1950092,24944,2384,1355753,594336,930784,1019310,11885,13059,1158,1226
2019년1분기,골목상권,연서로41길,은평구,불광2동,1119528,18936,1549,788913,330624,568518,551007,9238,9698,818,731
2019년2분기,골목상권,연서로41길,은평구,불광2동,1124680,18936,2137,774257,350425,573843,550832,9238,9698,1059,1078
2019년1분기,골목상권,연서로5길,은평구,역촌동,1476513,27206,2341,1036243,440281,712066,764446,12921,14285,1209,1132
2019년2분기,골목상권,연서로5길,은평구,역촌동,2802234,27206,2879,1970445,831791,1306004,1496228,12921,14285,1436,1443
2019년1분기,골목상권,홍제내길,서대문구,홍제1동,683383,13479,1237,483533,199866,318794,364595,6339,7140,532,705
2019년2분기,골목상권,홍제내길,서대문구,홍제1동,878165,13479,1402,609310,268852,412288,465877,6339,7140,870,532
2019년1분기,골목상권,광성로6길,마포구,신수동,1761406,15707,4449,1325288,436127,955865,805536,7896,7811,2444,2005
2019년2분기,골목상권,광성로6길,마포구,신수동,2161748,15707,4955,1627128,534620,1153756,1008005,7896,7811,2743,2212
2019년1분기,골목상권,대흥로21길,마포구,대흥동,5303738,14066,6556,3861785,1441968,2346641,2957101,6663,7403,3160,3396
2019년2분기,골목상권,대흥로21길,마포구,대흥동,6039719,14066,3489,4370080,1669646,2650057,3389664,6663,7403,1676,1813
2019년1분기,골목상권,화랑로1길,성북구,월곡1동,1847248,23938,4370,1309095,538165,910887,936372,11782,12156,2308,2062
2019년2분기,골목상권,화랑로1길,성북구,월곡1동,2276335,23938,4209,1598078,678272,1097807,1178522,11782,12156,2706,1503
2019년1분기,골목상권,화랑로32길,성북구,석관동,1424471,14559,2485,1030665,393824,709491,714981,7120,7439,1116,1369
2019년2분기,골목상권,화랑로32길,성북구,석관동,1782727,14559,1558,1277965,504777,860938,921780,7120,7439,926,632
2019년1분기,골목상권,화랑로40길,성북구,석관동,1444963,11428,3635,1030395,414583,781672,663287,5838,5590,2270,1365
2019년2분기,골목상권,화랑로40길,성북구,석관동,1610521,11428,2603,1134081,476449,845278,765244,5838,5590,1739,864
2019년1분기,골목상권,도봉로114길,도봉구,창1동,2884788,21874,2887,2057899,826885,1370767,1514026,10663,11211,1370,1517
2019년2분기,골목상권,도봉로114길,도봉구,창1동,3385948,21874,1761,2345249,1040723,1603087,1782861,10663,11211,975,786
2019년1분기,골목상권,도봉로143길,도봉구,방학1동,961999,16598,2700,672735,289258,501516,460491,8226,8372,1304,1396
2019년2분기,골목상권,도봉로143길,도봉구,방학1동,1196332,16598,1841,821816,374521,611560,584776,8226,8372,1035,806
2019년1분기,골목상권,도봉로147길,도봉구,방학1동,1158044,21316,3136,812893,345157,606692,551368,10685,10631,1562,1574
2019년2분기,골목상권,도봉로147길,도봉구,방학1동,1370594,21316,2182,939873,430732,717311,653297,10685,10631,1345,837
2019년1분기,골목상권,은평로10길,은평구,응암1동,1862900,21760,3809,1321548,541343,866802,996101,10467,11293,1669,2140
2019년2분기,골목상권,은평로10길,은평구,응암1동,2209404,21760,2797,1557147,652277,1011295,1198101,10467,11293,1608,1189
2019년1분기,골목상권,은평로13길,은평구,녹번동,2031121,23069,7151,1439346,591783,954432,1076696,11046,12023,3405,3746
2019년2분기,골목상권,은평로13길,은평구,녹번동,2420887,23069,5112,1705310,715570,1109472,1311408,11046,12023,2783,2329
2019년1분기,골목상권,은평로20길,은평구,응암1동,807488,9448,3585,597637,209867,421917,385568,4568,4880,1680,1905
2019년2분기,골목상권,은평로20길,은평구,응암1동,895176,9448,3395,652632,242543,472990,422191,4568,4880,1793,1602
2019년1분기,골목상권,대흥로28길,마포구,염리동,1969132,8426,1769,1456601,512539,823447,1145685,3834,4592,715,1054
2019년2분기,골목상권,대흥로28길,마포구,염리동,2292096,8426,1052,1701978,590125,965243,1326848,3834,4592,424,628
2019년1분기,골목상권,도화4길,마포구,도화동,2873464,24656,21909,2209457,664011,1508563,1364905,11641,13015,12497,9412
2019년2분기,골목상권,도화4길,마포구,도화동,3236893,24656,18635,2473110,763779,1676763,1560126,11641,13015,12105,6530
2019년1분기,골목상권,도화길,마포구,도화동,3619486,18116,31337,2827021,792477,1927800,1691690,8390,9726,18021,13316
2019년2분기,골목상권,도화길,마포구,도화동,4052565,18116,24419,3157734,894826,2125531,1927031,8390,9726,15675,8744
2019년1분기,골목상권,노해로17길,강북구,수유3동,2064261,22685,4792,1434162,630111,1057860,1006399,11158,11527,2380,2412
2019년2분기,골목상권,노해로17길,강북구,수유3동,2385735,22685,3300,1641255,744484,1196779,1188957,11158,11527,1576,1724
2019년1분기,골목상권,노해로23길,강북구,수유2동,1288450,17028,1640,918966,369498,640034,648413,8355,8673,761,879
2019년2분기,골목상권,노해로23길,강북구,수유2동,1524508,17028,1610,1068020,456484,733960,790537,8355,8673,1110,500
2019년1분기,골목상권,노해로33길,강북구,수유2동,1217069,15854,1934,867581,349510,593043,624025,7763,8091,844,1090
2019년2분기,골목상권,노해로33길,강북구,수유2동,1442302,15854,1321,1011379,430924,672704,769587,7763,8091,631,690
2019년1분기,골목상권,도봉로152가길,도봉구,도봉2동,314686,14703,2537,226789,87903,174385,140305,7398,7305,1419,1118
2019년2분기,골목상권,도봉로152가길,도봉구,도봉2동,403780,14703,1505,281452,122325,217289,186489,7398,7305,934,571
2019년1분기,골목상권,도봉로156길,도봉구,도봉2동,489340,13985,2949,354556,134793,259067,230283,7068,6917,1620,1329
2019년2분기,골목상권,도봉로156길,도봉구,도봉2동,593547,13985,1558,416642,176893,308210,285336,7068,6917,1071,487
2019년1분기,골목상권,도봉로169나길,도봉구,도봉1동,270931,11676,2020,194239,76698,150609,120320,5883,5793,1155,865
2019년2분기,골목상권,도봉로169나길,도봉구,도봉1동,347672,11676,1282,240641,107045,187238,160435,5883,5793,907,375
2019년1분기,골목상권,은평로3길,은평구,역촌동,2570984,25749,3035,1809796,761204,1255625,1315366,12189,13560,1417,1618
2019년2분기,골목상권,은평로3길,은평구,역촌동,3484118,25749,2831,2427752,1056353,1657885,1826238,12189,13560,1418,1413
2019년1분기,골목상권,은평로8길,은평구,응암1동,3899546,22805,2908,2748214,1151346,1876602,2022957,10869,11936,1279,1629
2019년2분기,골목상권,은평로8길,은평구,응암1동,4415687,22805,2570,3075904,1339781,2105740,2309938,10869,11936,1608,962
2019년1분기,골목상권,응암로12길,은평구,응암3동,1938815,14933,1786,1358438,580376,1001814,936999,7433,7500,712,1074
2019년2분기,골목상권,응암로12길,은평구,응암3동,2396497,14933,1541,1665844,730659,1218831,1177664,7433,7500,605,936
2019년1분기,골목상권,독막로22길,마포구,서강동,924335,13049,5337,684601,239752,460298,464041,6175,6874,2619,2718
2019년2분기,골목상권,독막로22길,마포구,서강동,1105173,13049,2697,806901,298260,533569,571608,6175,6874,1604,1093
2019년1분기,골목상권,독막로32길,마포구,신수동,2108749,19674,4840,1565987,542773,1095343,1013407,9690,9984,2656,2184
2019년2분기,골목상권,독막로32길,마포구,신수동,2506530,19674,5615,1848647,657889,1287166,1219375,9690,9984,3148,2467
2019년1분기,골목상권,독막로8길,마포구,합정동,1954578,7855,6944,1306095,648485,966275,988300,3713,4142,3785,3159
2019년2분기,골목상권,독막로8길,마포구,합정동,2460402,7855,5671,1639421,820982,1206762,1253641,3713,4142,3372,2299
2019년1분기,골목상권,덕릉로40길,강북구,번2동,713056,12865,2293,496280,216778,358196,354857,6355,6510,1460,833
2019년2분기,골목상권,덕릉로40길,강북구,번2동,870552,12865,1148,592960,277590,435637,434919,6355,6510,456,692
2019년1분기,골목상권,덕릉로41길,강북구,번1동,3579129,16731,7030,2518612,1060506,1782208,1796925,8295,8436,3606,3424
2019년2분기,골목상권,덕릉로41길,강북구,번1동,4209646,16731,4717,2924199,1285436,2067444,2142199,8295,8436,2479,2238
2019년1분기,골목상권,도봉로13길,강북구,송천동,1474791,11587,1557,1060331,414440,707104,767680,5788,5799,607,950
2019년2분기,골목상권,도봉로13길,강북구,송천동,1709933,11587,989,1211926,498012,806962,902968,5788,5799,622,367
2019년1분기,골목상권,도봉로181길,도봉구,도봉1동,271364,15188,1648,175570,95802,147947,123419,7534,7654,879,769
2019년2분기,골목상권,도봉로181길,도봉구,도봉1동,365089,15188,1891,229135,135962,191434,173645,7534,7654,842,1049
2019년1분기,골목상권,도봉산길,도봉구,도봉1동,179367,9730,1632,109488,69888,99995,79373,4869,4861,1164,468
2019년2분기,골목상권,도봉산길,도봉구,도봉1동,255029,9730,1628,151957,103084,136273,118749,4869,4861,694,934
2019년1분기,골목상권,방학로10길,도봉구,방학2동,1053656,18630,1790,743129,310520,557181,496485,9249,9381,701,1089
2019년2분기,골목상권,방학로10길,도봉구,방학2동,1289335,18630,1371,893123,396211,666881,622457,9249,9381,684,687
2019년1분기,골목상권,응암로13길,은평구,응암3동,1660628,15637,2333,1154818,505812,861833,798791,7640,7997,1040,1293
2019년2분기,골목상권,응암로13길,은평구,응암3동,2095057,15637,1780,1444655,650413,1068958,1026100,7640,7997,827,953
2019년1분기,골목상권,응암로14길,은평구,응암3동,1824335,20067,1669,1292237,532094,935617,888713,9812,10255,693,976
2019년2분기,골목상권,응암로14길,은평구,응암3동,2352118,20067,1190,1648385,703746,1185687,1166436,9812,10255,497,693
2019년1분기,골목상권,응암로22길,은평구,응암3동,1814875,18065,1782,1290498,524403,900017,914865,8807,9258,817,965
2019년2분기,골목상권,응암로22길,은평구,응암3동,2051093,18065,1780,1443095,608002,1027230,1023858,8807,9258,983,797
2019년1분기,골목상권,동교로17길,마포구,서교동,2021905,13704,15639,1513975,507927,994087,1027814,6402,7302,8061,7578
2019년2분기,골목상권,동교로17길,마포구,서교동,2397905,13704,11590,1785807,612102,1176228,1221680,6402,7302,5988,5602
2019년1분기,골목상권,동교로19길,마포구,서교동,1691255,11494,14225,1261946,429305,837351,853898,5343,6151,7970,6255
2019년2분기,골목상권,동교로19길,마포구,서교동,1989005,11494,8710,1480565,508454,980564,1008445,5343,6151,4604,4106
2019년1분기,골목상권,동교로25길,마포구,연남동,2067259,10099,12470,1494606,572654,995549,1071697,4692,5407,6412,6058
2019년2분기,골목상권,동교로25길,마포구,연남동,2482316,10099,8773,1782826,699496,1178349,1303962,4692,5407,4722,4051
2019년1분기,골목상권,도봉로18길,강북구,송중동,1489422,13486,2885,1071982,417428,682745,806668,6534,6952,1303,1582
2019년2분기,골목상권,도봉로18길,강북구,송중동,1915707,13486,1544,1373188,542528,885014,1030704,6534,6952,737,807
2019년1분기,골목상권,도봉로45길,강북구,미아동,1623820,18340,2875,1152854,470984,743629,880195,8966,9374,1260,1615
2019년2분기,골목상권,도봉로45길,강북구,미아동,2146957,18340,1947,1507394,639581,946107,1200843,8966,9374,983,964
2019년1분기,골목상권,도봉로67길,강북구,미아동,1422500,15728,2058,1006161,416339,686753,735745,7618,8110,877,1181
2019년2분기,골목상권,도봉로67길,강북구,미아동,1801158,15728,1632,1263438,537732,852484,948684,7618,8110,906,726
2019년1분기,골목상권,방학로15길,도봉구,방학3동,488498,17907,1390,352410,136087,243379,245118,8808,9099,673,717
2019년2분기,골목상권,방학로15길,도봉구,방학3동,576419,17907,2172,398927,177483,273454,302957,8808,9099,1471,701
2019년1분기,골목상권,방학로5길,도봉구,쌍문2동,1595821,22302,3573,1118462,477351,821183,774638,10873,11429,1502,2071
2019년2분기,골목상권,방학로5길,도봉구,쌍문2동,2028196,22302,2262,1375176,653017,1017018,1011175,10873,11429,1120,1142
2019년1분기,골목상권,방학로6가길,도봉구,방학1동,1509674,21121,1759,1055269,454404,803592,706096,10590,10531,701,1058
2019년2분기,골목상권,방학로6가길,도봉구,방학1동,1786483,21121,1110,1229629,556868,937615,848875,10590,10531,526,584
2019년1분기,골목상권,올림픽로71길,강동구,천호2동,1725619,12805,3602,1218686,506945,802548,923080,6438,6367,1756,1846
2019년2분기,골목상권,올림픽로71길,강동구,천호2동,2187393,12805,2257,1521872,665521,990504,1196890,6438,6367,1124,1133
2019년1분기,골목상권,올림픽로77길,강동구,천호2동,1611348,15324,3521,1146579,464779,778864,832492,7742,7582,1763,1758
2019년2분기,골목상권,올림픽로77길,강동구,천호2동,2102571,15324,2054,1468034,634534,991074,1111506,7742,7582,1050,1004
2019년1분기,골목상권,올림픽로78길,강동구,천호2동,1515474,14230,3217,1059476,456005,776494,738982,7133,7097,1496,1721
2019년2분기,골목상권,올림픽로78길,강동구,천호2동,1948090,14230,1759,1346416,601667,961619,986478,7133,7097,873,886
2019년1분기,골목상권,백제고분로34길,송파구,석촌동,891686,24925,5176,631879,259817,458778,432913,11994,12931,3024,2152
2019년2분기,골목상권,백제고분로34길,송파구,석촌동,1397560,24925,5775,978515,419047,699485,698072,11994,12931,3807,1968
2019년1분기,골목상권,백제고분로39길,송파구,석촌동,1350290,16354,5956,977501,372791,664267,686024,7731,8623,3041,2915
2019년2분기,골목상권,백제고분로39길,송파구,석촌동,1667778,16354,6431,1182888,484903,820538,847242,7731,8623,4340,2091
2019년1분기,골목상권,백제고분로42길,송파구,송파1동,1537065,17713,6369,1132275,404804,746194,790871,8530,9183,3279,3090
2019년2분기,골목상권,백제고분로42길,송파구,송파1동,1881532,17713,9117,1362959,518575,895729,985794,8530,9183,5781,3336
2019년1분기,골목상권,올림픽로80길,강동구,천호2동,1386141,17130,2999,951354,434784,733698,652442,8691,8439,1319,1680
2019년2분기,골목상권,올림픽로80길,강동구,천호2동,1762829,17130,1683,1192321,570504,894826,867998,8691,8439,783,900
2019년1분기,골목상권,올림픽로98길,강동구,암사1동,2262396,27578,2741,1613721,648687,1161931,1100467,13811,13767,1248,1493
2019년2분기,골목상권,올림픽로98길,강동구,암사1동,2578163,27578,2292,1819766,758397,1310105,1268060,13811,13767,1267,1025
2019년1분기,골목상권,진황도로27길,강동구,천호3동,2941435,33472,6676,2056640,884803,1522201,1419253,16550,16922,3348,3328
2019년2분기,골목상권,진황도로27길,강동구,천호3동,3565159,33472,6581,2461727,1103439,1811421,1753732,16550,16922,3643,2938
2019년1분기,골목상권,백제고분로45길,송파구,송파1동,2034278,23424,9568,1444567,589714,1011486,1022793,11155,12269,5497,4071
2019년2분기,골목상권,백제고분로45길,송파구,송파1동,2758888,23424,19492,1909098,849801,1336619,1422266,11155,12269,10586,8906
2019년1분기,골목상권,백제고분로46길,송파구,송파1동,1700466,25507,5607,1218241,482224,832267,868198,12201,13306,3234,2373
2019년2분기,골목상권,백제고분로46길,송파구,송파1동,2040595,25507,15970,1434394,606211,976728,1063864,12201,13306,11329,4641
2019년1분기,골목상권,백제고분로50길,송파구,방이2동,1423398,23274,10074,1017122,406294,732182,691212,11362,11912,5904,4170
2019년2분기,골목상권,백제고분로50길,송파구,방이2동,2016570,23274,12352,1407575,608992,1004225,1012339,11362,11912,7584,4768
2019년1분기,골목상권,진황도로47길,강동구,길동,3242885,17719,5739,2345509,897373,1661901,1580981,8780,8939,2640,3099
2019년2분기,골목상권,진황도로47길,강동구,길동,3800454,17719,4354,2732719,1067738,1921773,1878683,8780,8939,2115,2239
2019년1분기,골목상권,천중로39길,강동구,천호1동,2760877,27338,4166,1963983,796893,1395116,1365758,13506,13832,2116,2050
2019년2분기,골목상권,천중로39길,강동구,천호1동,3287821,27338,3865,2304884,982946,1637194,1650635,13506,13832,2291,1574
2019년1분기,골목상권,천중로51길,강동구,명일1동,2520618,26251,4107,1784147,736468,1294991,1225623,12738,13513,1979,2128
2019년2분기,골목상권,천중로51길,강동구,명일1동,3178666,26251,3333,2223125,955545,1593357,1585315,12738,13513,1953,1380
2019년1분기,골목상권,삼전로13길,송파구,잠실본동,2734740,36747,7039,1934852,799894,1392056,1342690,17621,19126,3497,3542
2019년2분기,골목상권,삼전로13길,송파구,잠실본동,3397823,36747,11553,2356765,1041063,1706063,1691768,17621,19126,7233,4320
2019년1분기,골목상권,송이로23길,송파구,가락2동,1510195,23102,14427,1124675,385511,813173,697030,11446,11656,7607,6820
2019년2분기,골목상권,송이로23길,송파구,가락2동,1792391,23102,11388,1318633,473773,939722,852672,11446,11656,6450,4938
2019년1분기,골목상권,송이로32길,송파구,문정1동,1537008,23730,8768,1136821,400174,807907,729099,11778,11952,5116,3652
2019년2분기,골목상권,송이로32길,송파구,문정1동,1905502,23730,35416,1386003,519507,968881,936625,11778,11952,26954,8462
2019년1분기,골목상권,천호대로162길,강동구,성내2동,3214980,28146,6100,2264057,950928,1578350,1636628,13826,14320,3095,3005
2019년2분기,골목상권,천호대로162길,강동구,성내2동,3897208,28146,11820,2705133,1192069,1889876,2007323,13826,14320,6646,5174
2019년1분기,골목상권,천호대로170길,강동구,성내2동,3255534,32460,6685,2323662,931879,1645745,1609790,15847,16613,3501,3184
2019년2분기,골목상권,천호대로170길,강동구,성내2동,3864901,32460,12826,2733333,1131563,1936830,1928070,15847,16613,6999,5827
2019년1분기,골목상권,천호대로187길,강동구,길동,2699985,21567,6880,1944704,755282,1372085,1327904,10771,10796,3270,3610
2019년2분기,골목상권,천호대로187길,강동구,길동,3142515,21567,5819,2243712,898798,1576325,1566190,10771,10796,2884,2935
2019년1분기,골목상권,송이로36길,송파구,문정1동,1580332,24668,24089,1144785,435545,837578,742746,11797,12871,14780,9309
2019년2분기,골목상권,송이로36길,송파구,문정1동,1932428,24668,5840,1392576,539865,1005651,926782,11797,12871,3661,2179
2019년1분기,골목상권,송파대로30길,송파구,가락본동,1945717,15978,19449,1467428,478292,1103059,842661,7968,8010,10990,8459
2019년2분기,골목상권,송파대로30길,송파구,가락본동,2274770,15978,23245,1702244,572529,1256019,1018751,7968,8010,14306,8939
2019년1분기,골목상권,양재대로62길,송파구,가락본동,1387930,15339,10029,1023431,364499,762838,625097,7581,7758,4403,5626
2019년2분기,골목상권,양재대로62길,송파구,가락본동,1623541,15339,17572,1187088,436467,863126,760420,7581,7758,10016,7556
2019년1분기,골목상권,천호대로197길,강동구,길동,1461185,21885,2483,1027544,433624,728933,732251,10817,11068,1357,1126
2019년2분기,골목상권,천호대로197길,강동구,길동,1742709,21885,1996,1214640,528059,852106,890599,10817,11068,1108,888
2019년1분기,골목상권,천호대로219길,강동구,상일동,140226,5262,19289,118779,21445,95449,44782,2676,2586,15615,3674
2019년2분기,골목상권,천호대로219길,강동구,상일동,197220,5262,1171,162284,34931,129539,67683,2676,2586,816,355
2019년1분기,골목상권,천호옛14길,강동구,성내2동,3204360,16300,5733,2241148,963215,1511917,1692444,8141,8159,2584,3149
2019년2분기,골목상권,천호옛14길,강동구,성내2동,3983885,16300,4362,2756964,1226918,1862103,2121778,8141,8159,2489,1873
2019년1분기,골목상권,양재대로64길,송파구,가락본동,1882204,19327,14051,1399849,482357,1025310,856897,9694,9633,7509,6542
2019년2분기,골목상권,양재대로64길,송파구,가락본동,2197146,19327,16223,1615990,581158,1161485,1035662,9694,9633,9945,6278
2019년1분기,골목상권,양재대로71길,송파구,방이1동,1254429,15238,8462,914460,339979,636969,617463,7300,7938,5071,3391
2019년2분기,골목상권,양재대로71길,송파구,방이1동,1551175,15238,7677,1095417,455760,762314,788864,7300,7938,5030,2647
2019년1분기,골목상권,양재대로72길,송파구,오금동,978436,18865,14423,713713,264728,500057,478381,9138,9727,9115,5308
2019년2분기,골목상권,양재대로72길,송파구,오금동,1230619,18865,20595,871591,359036,604748,625875,9138,9727,13764,6831
2019년1분기,골목상권,천호옛길,강동구,성내2동,3070192,22242,7256,2192650,877548,1485625,1584578,10954,11288,3545,3711
2019년2분기,골목상권,천호옛길,강동구,성내2동,3786483,22242,6413,2668990,1117508,1819086,1967396,10954,11288,3834,2579
2019년1분기,골목상권,풍성로37가길,강동구,성내2동,2607258,28320,3206,1856515,750750,1287202,1320057,13999,14321,1627,1579
2019년2분기,골목상권,풍성로37가길,강동구,성내2동,3042301,28320,2935,2132983,909326,1486009,1556282,13999,14321,1774,1161
2019년1분기,골목상권,오금로11길,송파구,방이2동,2602288,23040,14317,1840426,761859,1362931,1239349,11030,12010,8747,5570
2019년2분기,골목상권,오금로11길,송파구,방이2동,3443053,23040,23598,2376728,1066318,1750579,1692472,11030,12010,14142,9456
2019년1분기,골목상권,오금로36길,송파구,가락본동,1182269,17333,7935,891656,290617,626261,556009,8519,8814,4884,3051
2019년2분기,골목상권,오금로36길,송파구,가락본동,1407370,17333,9074,1049710,357658,727295,680081,8519,8814,6223,2851
2019년1분기,골목상권,오금로46길,송파구,가락2동,1338145,22898,3370,946309,391853,667600,670542,11111,11787,1639,1731
2019년2분기,골목상권,오금로46길,송파구,가락2동,1614498,22898,4694,1131979,482523,800189,814313,11111,11787,2860,1834
2019년1분기,골목상권,풍성로25길,송파구,풍납1동,1937040,15289,3694,1362903,574144,932182,1004872,7581,7708,1765,1929
2019년2분기,골목상권,풍성로25길,송파구,풍납1동,2340931,15289,2719,1628319,712623,1124089,1216843,7581,7708,1449,1270
2019년1분기,골목상권,강동대로53길,강동구,성내3동,1158018,14233,9080,811250,346771,618821,539188,7095,7138,5236,3844
2019년2분기,골목상권,강동대로53길,강동구,성내3동,1439804,14233,4322,986067,453762,756005,683814,7095,7138,2679,1643
2019년1분기,골목상권,고덕로10길,강동구,암사1동,2055084,24978,4067,1463797,591283,1056460,998629,12369,12609,1688,2379
2019년2분기,골목상권,고덕로10길,강동구,암사1동,2340629,24978,3531,1651017,689618,1190166,1150470,12369,12609,1636,1895
2019년1분기,골목상권,선릉로121길,강남구,논현2동,2605147,10697,22776,2085101,520054,1373960,1231193,5044,5653,11582,11194
2019년2분기,골목상권,선릉로121길,강남구,논현2동,3173690,10697,19126,2527102,646580,1636050,1537632,5044,5653,11898,7228
2019년1분기,골목상권,선릉로132길,강남구,청담동,2742077,17662,16985,2151393,590691,1354323,1387753,8325,9337,8368,8617
2019년2분기,골목상권,선릉로132길,강남구,청담동,3877312,17662,14903,3023216,854078,1873736,2003571,8325,9337,8743,6160
2019년1분기,골목상권,선릉로133길,강남구,논현2동,2496955,8299,27951,2007607,489349,1296072,1200883,3861,4438,16034,11917
2019년2분기,골목상권,선릉로133길,강남구,논현2동,3450903,8299,21360,2750918,699976,1736176,1714723,3861,4438,13524,7836
2019년1분기,골목상권,고덕로25길,강동구,암사3동,492572,14026,969,359723,132852,259729,232843,7008,7018,411,558
2019년2분기,골목상권,고덕로25길,강동구,암사3동,569952,14026,1218,409826,160119,294331,275626,7008,7018,701,517
2019년1분기,골목상권,고덕로61길,강동구,고덕1동,160769,17436,1181,119841,40930,79399,81366,8854,8582,452,729
2019년2분기,골목상권,고덕로61길,강동구,고덕1동,242093,17436,1312,176664,65439,123067,119030,8854,8582,682,630
2019년1분기,골목상권,구천면로36길,강동구,천호1동,1800404,26672,1523,1260167,540234,935093,865323,13585,13087,708,815
2019년2분기,골목상권,구천면로36길,강동구,천호1동,2130460,26672,1611,1460074,670406,1084720,1045731,13585,13087,879,732
2019년1분기,골목상권,선릉로146길,강남구,청담동,1505917,9678,23244,1117018,388906,691100,814823,4468,5210,9445,13799
2019년2분기,골목상권,선릉로146길,강남구,청담동,2030365,9678,22906,1507304,523043,907264,1123096,4468,5210,11534,11372
2019년1분기,골목상권,선릉로18길,강남구,개포2동,158813,3467,1202,120911,37903,83435,75381,1692,1775,634,568
2019년2분기,골목상권,선릉로18길,강남구,개포2동,233642,3467,4350,164882,68761,112517,121120,1692,1775,2826,1524
2019년1분기,골목상권,압구정로2길,강남구,신사동,1796615,10275,11938,1304975,491632,828335,968282,4885,5390,5835,6103
2019년2분기,골목상권,압구정로2길,강남구,신사동,2263525,10275,14779,1616886,646636,1021857,1241670,4885,5390,9440,5339
2019년1분기,골목상권,구천면로41길,강동구,천호2동,3717778,28177,2948,2661075,1056710,1946990,1770782,14075,14102,1277,1671
2019년2분기,골목상권,구천면로41길,강동구,천호2동,4111868,28177,2629,2894279,1217592,2134700,1977170,14075,14102,1447,1182
2019년1분기,골목상권,구천면로42길,강동구,천호1동,4300331,31916,2229,3079225,1221110,2221101,2079225,15901,16015,966,1263
2019년2분기,골목상권,구천면로42길,강동구,천호1동,4520602,31916,2731,3179983,1340639,2327998,2192615,15901,16015,1409,1322
2019년1분기,골목상권,동남로65길,강동구,명일2동,304603,12517,1564,195012,109598,137256,167348,6218,6299,844,720
2019년2분기,골목상권,동남로65길,강동구,명일2동,387338,12517,997,250066,137270,171713,215624,6218,6299,494,503
2019년1분기,골목상권,언주로81길,강남구,역삼2동,3428994,17425,81416,2815900,613102,1913164,1515833,8366,9059,48334,33082
2019년2분기,골목상권,언주로81길,강남구,역삼2동,4118016,17425,92700,3365963,752054,2268335,1849692,8366,9059,56558,36142
2019년1분기,골목상권,영동대로112길,강남구,삼성1동,1083190,7775,43658,864293,218901,572324,510862,3849,3926,27507,16151
2019년2분기,골목상권,영동대로112길,강남구,삼성1동,1401131,7775,62892,1081222,319912,711644,689491,3849,3926,48029,14863
2019년1분기,골목상권,영동대로65길,강남구,대치2동,1887959,15075,15936,1386041,501928,1040456,847497,7795,7280,10123,5813
2019년2분기,골목상권,영동대로65길,강남구,대치2동,2133743,15075,28380,1539700,594037,1164525,969217,7795,7280,17099,11281
2019년1분기,골목상권,동남로85길,강동구,고덕1동,171059,13231,1138,127915,43150,86553,84503,6793,6438,564,574
2019년2분기,골목상권,동남로85길,강동구,고덕1동,241267,13231,1212,174378,66897,121259,120011,6793,6438,635,577
2019년1분기,골목상권,명일로13길,강동구,둔촌2동,1825867,23136,4447,1311336,514538,924605,901261,11442,11694,2383,2064
2019년2분기,골목상권,명일로13길,강동구,둔촌2동,2137446,23136,8097,1517545,619898,1070557,1066890,11442,11694,4174,3923
2019년1분기,골목상권,상암로14길,강동구,천호2동,2022492,21533,3364,1442521,579974,1042300,980189,10838,10695,1539,1825
2019년2분기,골목상권,상암로14길,강동구,천호2동,2312395,21533,2550,1629908,682491,1173915,1138491,10838,10695,1309,1241
2019년1분기,골목상권,일원로3길,강남구,일원1동,1265217,14488,4254,955041,310188,665776,599440,7238,7250,2288,1966
2019년2분기,골목상권,일원로3길,강남구,일원1동,1549958,14488,3417,1153011,396947,798346,751610,7238,7250,2107,1310
2019년1분기,골목상권,일원로9길,강남구,일원1동,1197721,14006,8787,904438,293283,622193,575524,6960,7046,2499,6288
2019년2분기,골목상권,일원로9길,강남구,일원1동,1466221,14006,10670,1091773,374453,745646,720573,6960,7046,3745,6925
2019년1분기,골목상권,테헤란로81길,강남구,삼성1동,1589353,3131,60392,1337590,251771,936766,652587,1554,1577,34808,25584
2019년2분기,골목상권,테헤란로81길,강남구,삼성1동,2130494,3131,50658,1779035,351466,1212741,917760,1554,1577,28954,21704
2019년1분기,골목상권,상암로4길,강동구,천호2동,1772850,22129,3184,1269244,503600,913156,859698,11025,11104,1467,1717
2019년2분기,골목상권,상암로4길,강동구,천호2동,2039133,22129,2372,1440422,598717,1038158,1000980,11025,11104,1253,1119
2019년1분기,골목상권,상암로51길,강동구,명일1동,2216275,22482,4031,1513037,703249,1105135,1111140,10974,11508,1551,2480
2019년2분기,골목상권,상암로51길,강동구,명일1동,2924771,22482,2483,1968946,955824,1406928,1517841,10974,11508,1110,1373
2019년1분기,골목상권,상암로5길,강동구,암사2동,1931320,22266,4210,1376778,554533,988642,942680,10964,11302,1713,2497
2019년2분기,골목상권,상암로5길,강동구,암사2동,2209407,22266,4187,1558850,650564,1118323,1091088,10964,11302,1957,2230
2019년1분기,골목상권,학동로38길,강남구,논현2동,1810246,6812,25805,1405019,405230,930609,879647,3206,3606,13356,12449
2019년2분기,골목상권,학동로38길,강남구,논현2동,2174443,6812,25857,1673457,500989,1093720,1080722,3206,3606,17165,8692
2019년1분기,골목상권,학동로56길,강남구,삼성2동,2863950,14342,18503,2280297,583650,1473586,1390376,6752,7590,9480,9023
2019년2분기,골목상권,학동로56길,강남구,삼성2동,3935424,14342,14323,3108249,827165,1968018,1967396,6752,7590,8655,5668
2019년1분기,골목상권,학동로6길,강남구,논현1동,1372811,13690,11649,1051193,321624,755642,617171,6331,7359,6488,5161
2019년2분기,골목상권,학동로6길,강남구,논현1동,1706347,13690,13269,1305020,401334,914926,791421,6331,7359,8632,4637
2019년1분기,골목상권,상일로5길,강동구,상일동,175166,6539,19326,149339,25827,118366,56804,3305,3234,15562,3764
2019년2분기,골목상권,상일로5길,강동구,상일동,241227,6539,1123,199136,42094,158567,82665,3305,3234,784,339
2019년1분기,골목상권,성내로5길,강동구,성내1동,2643128,21047,17580,1942928,700222,1311828,1331314,10271,10776,9425,8155
2019년2분기,골목상권,성내로5길,강동구,성내1동,3155761,21047,12105,2280303,875466,1560472,1595271,10271,10776,7423,4682
2019년1분기,골목상권,성안로3길,강동구,성내1동,1431095,15271,14683,1077005,354098,734953,696139,7485,7786,8585,6098
2019년2분기,골목상권,성안로3길,강동구,성내1동,1793807,15271,12518,1314216,479594,895482,898323,7485,7786,7819,4699
2019년1분기,골목상권,학동로77길,강남구,청담동,1212413,14877,11718,933065,279353,550014,662399,7028,7849,4826,6892
2019년2분기,골목상권,학동로77길,강남구,청담동,1547638,14877,25259,1186109,361514,696110,851526,7028,7849,10976,14283
2019년1분기,골목상권,거마로20길,송파구,마천2동,1131580,16584,2973,796694,334900,600567,531006,8441,8143,1655,1318
2019년2분기,골목상권,거마로20길,송파구,마천2동,1353707,16584,1854,944861,408855,711616,642097,8441,8143,894,960
2019년1분기,골목상권,동남로20길,송파구,가락2동,1519543,18932,3685,1092884,426661,754476,765062,9237,9695,1813,1872
2019년2분기,골목상권,동남로20길,송파구,가락2동,1821935,18932,6118,1302274,519678,899946,921996,9237,9695,3572,2546
2019년1분기,골목상권,암사길,강동구,암사1동,3430393,37477,2085,2461016,969390,1786982,1643414,18650,18827,1013,1072
2019년2분기,골목상권,암사길,강동구,암사1동,3801721,37477,3610,2679917,1121797,1969974,1831752,18650,18827,2190,1420
2019년1분기,골목상권,양재대로101길,강동구,성내3동,3546854,26996,9164,2529866,1017001,1791408,1755442,13215,13781,4224,4940
2019년2분기,골목상권,양재대로101길,강동구,성내3동,4233904,26996,8074,3004021,1229885,2123754,2110144,13215,13781,3845,4229
2019년1분기,골목상권,양재대로116길,강동구,길동,2506426,17769,5076,1815912,690504,1281493,1224933,8809,8960,2403,2673
2019년2분기,골목상권,양재대로116길,강동구,길동,2900444,17769,3422,2091050,809396,1465257,1435193,8809,8960,1642,1780
2019년1분기,골목상권,마천로51길,송파구,마천2동,1013625,18995,1975,710110,303526,553653,459967,9746,9249,969,1006
2019년2분기,골목상권,마천로51길,송파구,마천2동,1223085,18995,1973,851032,372066,660104,562980,9746,9249,1087,886
2019년1분기,골목상권,백제고분로21길,송파구,삼전동,1908563,24267,5498,1359589,548983,938792,969776,11586,12681,2713,2785
2019년2분기,골목상권,백제고분로21길,송파구,삼전동,2238531,24267,11106,1575476,663063,1084646,1153890,11586,12681,6995,4111
2019년1분기,골목상권,백제고분로22길,송파구,삼전동,852778,24574,4947,607522,245260,442309,410470,11851,12723,2835,2112
2019년2분기,골목상권,백제고분로22길,송파구,삼전동,1059449,24574,5097,747697,311764,550295,509156,11851,12723,3319,1778
2019년1분기,골목상권,양재대로124길,강동구,길동,2221381,25504,4045,1587634,633733,1125542,1095844,12481,13023,2126,1919
2019년2분기,골목상권,양재대로124길,강동구,길동,2835068,25504,3828,2012549,822523,1409966,1425109,12481,13023,2324,1504
2019년1분기,골목상권,양재대로133길,강동구,천호1동,3632055,26417,4228,2600129,1031930,1860610,1771435,12965,13452,1829,2399
2019년2분기,골목상권,양재대로133길,강동구,천호1동,4104949,26417,3936,2889292,1215662,2078355,2026598,12965,13452,2078,1858
2019년1분기,골목상권,양재대로91길,강동구,성내3동,1815759,21081,5532,1290323,525441,956369,859384,10489,10592,3177,2355
2019년2분기,골목상권,양재대로91길,강동구,성내3동,2126319,21081,3801,1492986,633355,1097436,1028894,10489,10592,2223,1578
2019년1분기,골목상권,백제고분로31길,송파구,삼전동,2215957,28720,8502,1568425,647520,1103478,1112482,13594,15126,4758,3744
2019년2분기,골목상권,백제고분로31길,송파구,삼전동,3014939,28720,10949,2108706,906233,1469997,1544946,13594,15126,7355,3594
2019년1분기,골목상권,백제고분로32길,송파구,삼전동,780604,25410,5602,555756,224855,407096,373506,12191,13219,3243,2359
2019년2분기,골목상권,백제고분로32길,송파구,삼전동,1153481,25410,6872,813820,339664,589138,564343,12191,13219,4466,2406
2019년1분기,골목상권,백제고분로33길,송파구,석촌동,1362059,23759,6827,955356,406700,691326,670738,11253,12506,4043,2784
2019년2분기,골목상권,백제고분로33길,송파구,석촌동,2069018,23759,7036,1432129,636886,1023840,1045182,11253,12506,4971,2065
2019년1분기,골목상권,양재대로95길,강동구,성내3동,2425889,23663,4888,1743874,682021,1255827,1170065,11664,11999,2876,2012
2019년2분기,골목상권,양재대로95길,강동구,성내3동,2796956,23663,3558,1992638,804327,1418658,1378287,11664,11999,2094,1464
2019년1분기,골목상권,양재대로96길,강동구,둔촌2동,1789379,19399,5252,1301793,487624,926987,862400,9546,9853,2985,2267
2019년2분기,골목상권,양재대로96길,강동구,둔촌2동,2056368,19399,5065,1484466,571911,1046174,1010191,9546,9853,2774,2291
2019년1분기,골목상권,올림픽로48길,강동구,성내1동,1292265,12523,20077,995116,297162,655381,636890,6070,6453,11204,8873
2019년2분기,골목상권,올림픽로48길,강동구,성내1동,1609330,12523,12893,1211348,397990,798069,811255,6070,6453,8149,4744
2019년1분기,골목상권,미성5길,관악구,미성동,1101110,19780,1998,783130,317988,558362,542749,9755,10025,830,1168
2019년2분기,골목상권,미성5길,관악구,미성동,1334162,19780,1478,931623,402544,663349,670819,9755,10025,719,759
2019년1분기,골목상권,법원단지9길,관악구,난곡동,1127304,19761,854,787971,339339,568409,558900,9848,9913,324,530
2019년2분기,골목상권,법원단지9길,관악구,난곡동,1340609,19761,947,921816,418806,673752,666863,9848,9913,511,436
2019년1분기,골목상권,법원단지길,관악구,난곡동,1180246,18848,1143,827120,353135,601361,578893,9321,9527,416,727
2019년2분기,골목상권,법원단지길,관악구,난곡동,1418219,18848,827,978657,439568,714617,703610,9321,9527,393,434
2019년1분기,골목상권,동광로39길,서초구,반포4동,663229,10488,6928,491993,171240,308924,354310,4829,5659,3631,3297
2019년2분기,골목상권,동광로39길,서초구,반포4동,989322,10488,16028,725878,263443,456912,532407,4829,5659,11533,4495
2019년1분기,골목상권,동산로10길,서초구,양재2동,673472,13070,9999,519707,153767,388355,285117,6524,6546,6302,3697
2019년2분기,골목상권,동산로10길,서초구,양재2동,821661,13070,9596,620806,200849,467029,354629,6524,6546,6055,3541
2019년1분기,골목상권,동산로19길,서초구,양재2동,1006734,14397,25883,805771,200962,591196,415534,7234,7163,14557,11326
2019년2분기,골목상권,동산로19길,서초구,양재2동,1207937,14397,18090,949681,258256,694235,513696,7234,7163,10602,7488
2019년1분기,골목상권,논현로8길,강남구,개포4동,464923,9524,6711,362266,102660,257982,206943,4733,4791,3919,2792
2019년2분기,골목상권,논현로8길,강남구,개포4동,595716,9524,3770,452552,143158,327631,268078,4733,4791,2475,1295
2019년1분기,골목상권,도곡로37길,강남구,역삼2동,2159564,24155,24575,1696393,463184,1113365,1046200,11542,12613,12021,12554
2019년2분기,골목상권,도곡로37길,강남구,역삼2동,2454559,24155,27418,1920029,534517,1231846,1222711,11542,12613,16462,10956
2019년1분기,골목상권,도산대로15길,강남구,신사동,1611034,6178,15871,1198455,412580,739649,871389,2775,3403,7769,8102
2019년2분기,골목상권,도산대로15길,강남구,신사동,2018499,6178,12413,1489653,528842,922401,1096095,2775,3403,6807,5606
2019년1분기,골목상권,상도로47길,동작구,상도1동,1285225,18284,4437,909433,375787,641020,644204,8895,9389,2423,2014
2019년2분기,골목상권,상도로47길,동작구,상도1동,1480619,18284,2701,1029878,450739,720089,760524,8895,9389,1283,1418
2019년1분기,골목상권,상도로61길,동작구,상도1동,1699852,16231,2666,1286542,413320,877176,822680,7957,8274,1309,1357
2019년2분기,골목상권,상도로61길,동작구,상도1동,2236391,16231,3185,1719223,517186,1173851,1062546,7957,8274,1684,1501
2019년1분기,골목상권,상도로62길,동작구,상도1동,2098756,24659,3077,1562867,535903,1066786,1031970,12057,12602,1585,1492
2019년2분기,골목상권,상도로62길,동작구,상도1동,2686881,24659,1876,2013581,673306,1377093,1309793,12057,12602,909,967
2019년1분기,골목상권,복은길,관악구,서림동,1147750,21996,1393,803102,344669,668879,478876,12293,9703,746,647
2019년2분기,골목상권,복은길,관악구,서림동,1232137,21996,1794,847560,384584,706915,525223,12293,9703,1093,701
2019년1분기,골목상권,봉천로13길,관악구,보라매동,1327339,25863,5588,931910,395447,667139,660208,12879,12984,2459,3129
2019년2분기,골목상권,봉천로13길,관악구,보라매동,1590535,25863,2149,1100318,490232,796952,793582,12879,12984,1182,967
2019년1분기,골목상권,봉천로33길,관악구,은천동,2636022,25762,4418,1870275,765742,1307241,1328778,12561,13201,1834,2584
2019년2분기,골목상권,봉천로33길,관악구,은천동,3135880,25762,7532,2205000,930897,1525317,1610575,12561,13201,3165,4367
2019년1분기,골목상권,방배천로4안길,서초구,방배2동,2208501,14012,6538,1609806,598699,1123877,1084619,6500,7512,3834,2704
2019년2분기,골목상권,방배천로4안길,서초구,방배2동,2547758,14012,6983,1850058,697696,1280141,1267612,6500,7512,3566,3417
2019년1분기,골목상권,마방로2길,서초구,양재2동,782591,6816,15944,612569,170022,461057,321544,3414,3402,9511,6433
2019년2분기,골목상권,마방로2길,서초구,양재2동,1006857,6816,12733,766904,239953,580242,426612,3414,3402,8561,4172
2019년1분기,골목상권,바우뫼로39길,서초구,양재1동,1207331,10048,27002,963823,243508,680528,526799,4833,5215,15953,11049
2019년2분기,골목상권,바우뫼로39길,서초구,양재1동,1464375,10048,41106,1155914,308464,813070,651296,4833,5215,20067,21039
2019년1분기,골목상권,도산대로23길,강남구,신사동,1513489,5605,18642,1146668,366822,705244,808247,2541,3064,8942,9700
2019년2분기,골목상권,도산대로23길,강남구,신사동,1855229,5605,14091,1396609,458618,862053,993171,2541,3064,7339,6752
2019년1분기,골목상권,도산대로30길,강남구,논현2동,1216667,4656,26638,989985,226687,661171,555493,2168,2488,13148,13490
2019년2분기,골목상권,도산대로30길,강남구,논현2동,1471126,4656,21865,1192901,278226,784223,686907,2168,2488,11878,9987
2019년1분기,골목상권,도산대로38길,강남구,논현2동,1203032,4495,31171,989710,213327,656736,546296,2118,2377,16466,14705
2019년2분기,골목상권,도산대로38길,강남구,논현2동,1455297,4495,22258,1190129,265166,774038,681255,2118,2377,12215,10043
2019년1분기,골목상권,서달로10길,동작구,흑석동,2387900,12309,2767,1815412,572487,1183083,1204818,6020,6289,914,1853
2019년2분기,골목상권,서달로10길,동작구,흑석동,3017764,12309,663,2321165,696603,1478353,1539406,6020,6289,387,276
2019년1분기,골목상권,서달로14길,동작구,흑석동,2717458,10256,2905,2072717,644735,1366658,1350797,4901,5355,909,1996
2019년2분기,골목상권,서달로14길,동작구,흑석동,3425910,10256,758,2641211,784703,1698583,1727329,4901,5355,411,347
2019년1분기,골목상권,서달로15길,동작구,흑석동,3759581,4893,2985,2901424,858149,1910129,1849450,2383,2510,937,2048
2019년2분기,골목상권,서달로15길,동작구,흑석동,4875239,4893,689,3815910,1059321,2436084,2439159,2383,2510,340,349
2019년1분기,골목상권,서림7길,관악구,서림동,1394596,17362,1772,983174,411423,833086,561510,10244,7118,1076,696
2019년2분기,골목상권,서림7길,관악구,서림동,1531564,17362,1708,1069509,462056,901012,630552,10244,7118,1051,657
2019년1분기,골목상권,승방길,관악구,남현동,1540802,13165,4496,1084045,456764,817294,723513,6162,7003,2575,1921
2019년2분기,골목상권,승방길,관악구,남현동,1826825,13165,3807,1285778,541041,948024,878805,6162,7003,2469,1338
2019년1분기,골목상권,신림동길,관악구,신림동,3202508,25008,3698,2186837,1015678,1676591,1525916,12597,12411,1829,1869
2019년2분기,골목상권,신림동길,관악구,신림동,3832837,25008,3501,2600193,1232655,1985812,1847028,12597,12411,1739,1762
2019년1분기,골목상권,반포대로9길,서초구,서초3동,981838,10700,8083,753492,228357,528999,452840,5305,5395,4968,3115
2019년2분기,골목상권,반포대로9길,서초구,서초3동,1143564,10700,14975,866720,276843,598660,544911,5305,5395,11362,3613
2019년1분기,골목상권,방배로18길,서초구,방배1동,1182920,13424,11128,911238,271687,604988,577938,6326,7098,5440,5688
2019년2분기,골목상권,방배로18길,서초구,방배1동,1444915,13424,13590,1110106,334821,719971,724948,6326,7098,9838,3752
2019년1분기,골목상권,방배로35길,서초구,방배본동,1449329,16613,7297,1071394,377942,719640,729697,7762,8851,4428,2869
2019년2분기,골목상권,방배로35길,서초구,방배본동,1841924,16613,12497,1344137,497796,887654,954266,7762,8851,8267,4230
2019년1분기,골목상권,도산대로50길,강남구,논현2동,2142754,7543,33401,1698798,443964,1114555,1028195,3537,4006,18077,15324
2019년2분기,골목상권,도산대로50길,강남구,논현2동,2920469,7543,21633,2304631,615827,1461373,1459093,3537,4006,11895,9738
2019년1분기,골목상권,도산대로81길,강남구,청담동,1012975,8072,17678,781744,231233,473130,539854,3696,4376,6291,11387
2019년2분기,골목상권,도산대로81길,강남구,청담동,1319591,8072,45427,1009350,310241,596830,722755,3696,4376,25601,19826
2019년1분기,골목상권,도산대로89길,강남구,청담동,724565,8303,11741,553948,170624,362265,362309,3813,4490,5193,6548
2019년2분기,골목상권,도산대로89길,강남구,청담동,911607,8303,35398,690839,220781,441268,470335,3813,4490,20349,15049
2019년1분기,골목상권,서달로8가길,동작구,흑석동,4004024,7908,5225,3077556,926461,2035258,1968765,3842,4066,2325,2900
2019년2분기,골목상권,서달로8가길,동작구,흑석동,5227210,7908,475,4076116,1151088,2617158,2610048,3842,4066,196,279
2019년1분기,골목상권,성대로1길,동작구,상도4동,1558531,19447,2198,1094329,464208,771180,787354,9413,10034,827,1371
2019년2분기,골목상권,성대로1길,동작구,상도4동,1758700,19447,1440,1219210,539482,855844,902858,9413,10034,636,804
2019년1분기,골목상권,성대로29길,동작구,상도4동,1402117,23995,2336,981940,420173,701940,700180,11706,12289,905,1431
2019년2분기,골목상권,성대로29길,동작구,상도4동,1625811,23995,1699,1124230,501570,789065,836742,11706,12289,789,910
2019년1분기,골목상권,신림로11길,관악구,대학동,2051915,18914,2006,1439380,612527,1270995,780925,11404,7510,1181,825
2019년2분기,골목상권,신림로11길,관악구,대학동,2243997,18914,2680,1563467,680512,1370866,873126,11404,7510,1853,827
2019년1분기,골목상권,신림로28길,관악구,서림동,2614663,21882,3099,1856937,757736,1525243,1089425,12254,9628,1821,1278
2019년2분기,골목상권,신림로28길,관악구,서림동,2929250,21882,2832,2048390,880857,1686795,1242459,12254,9628,2034,798
2019년1분기,골목상권,신림로38길,관악구,서림동,791197,18005,1209,550517,240703,453356,337848,9621,8384,634,575
2019년2분기,골목상권,신림로38길,관악구,서림동,855870,18005,1469,580904,274972,483331,372539,9621,8384,928,541
2019년1분기,골목상권,방배로42길,서초구,방배본동,1164178,13707,4598,873212,290977,562359,601821,6420,7287,2920,1678
2019년2분기,골목상권,방배로42길,서초구,방배본동,1396206,13707,16445,1035268,360947,657694,738511,6420,7287,10082,6363
2019년1분기,골목상권,사임당로17길,서초구,서초1동,2580464,10413,18595,2021013,559453,1455827,1124637,5020,5393,9499,9096
2019년2분기,골목상권,사임당로17길,서초구,서초1동,3107667,10413,18186,2423795,683880,1716064,1391605,5020,5393,10158,8028
2019년1분기,골목상권,사평대로22길,서초구,반포4동,699717,10438,5448,524076,175650,331898,367815,4850,5588,3213,2235
2019년2분기,골목상권,사평대로22길,서초구,반포4동,1034742,10438,14502,764392,270349,484402,550336,4850,5588,10889,3613
2019년1분기,골목상권,봉은사로109길,강남구,삼성1동,1067362,11638,20438,842203,225175,557257,510103,5828,5810,13550,6888
2019년2분기,골목상권,봉은사로109길,강남구,삼성1동,1390429,11638,31422,1061666,328764,696838,693596,5828,5810,24054,7368
2019년1분기,골목상권,봉은사로29길,강남구,논현2동,3000202,12490,27835,2339942,660270,1564235,1435972,5845,6645,14018,13817
2019년2분기,골목상권,봉은사로29길,강남구,논현2동,3633315,12490,26048,2820753,812565,1847134,1786176,5845,6645,16651,9397
2019년1분기,골목상권,봉은사로43길,강남구,논현2동,2398440,15267,24556,1916540,481920,1316589,1081858,7046,8221,12959,11597
2019년2분기,골목상권,봉은사로43길,강남구,논현2동,2893417,15267,26569,2301538,591873,1550742,1342670,7046,8221,16745,9824
2019년1분기,골목상권,신대방길,동작구,신대방1동,1224706,19205,4775,861076,363642,606590,618120,9403,9802,2481,2294
2019년2분기,골목상권,신대방길,동작구,신대방1동,1462429,19205,7354,1023836,438610,711538,750896,9403,9802,4580,2774
2019년1분기,골목상권,양녕로26길,동작구,상도4동,626362,15615,984,435084,191283,305709,320653,7734,7881,430,554
2019년2분기,골목상권,양녕로26길,동작구,상도4동,752463,15615,1652,517556,234904,360120,392335,7734,7881,1153,499
2019년1분기,골목상권,여의대방로22길,동작구,신대방2동,991235,15143,4322,716550,274691,512295,478943,7225,7918,2129,2193
2019년2분기,골목상권,여의대방로22길,동작구,신대방2동,1183864,15143,17909,845786,338075,602892,580977,7225,7918,11394,6515
2019년1분기,골목상권,신림로48길,관악구,서원동,860216,17901,928,583688,276532,449457,410764,9188,8713,456,472
2019년2분기,골목상권,신림로48길,관악구,서원동,1003625,17901,786,672346,331276,519209,484424,9188,8713,437,349
2019년1분기,골목상권,신림로64길,관악구,신림동,3132611,18343,4095,2142853,989769,1645418,1487193,9311,9032,1681,2414
2019년2분기,골목상권,신림로64길,관악구,신림동,3710566,18343,2309,2526756,1183794,1930492,1780079,9311,9032,943,1366
2019년1분기,골목상권,신림로65길,관악구,신림동,3957235,18365,4095,2656885,1300356,2092202,1865029,9274,9091,1859,2236
2019년2분기,골목상권,신림로65길,관악구,신림동,4720117,18365,3331,3154808,1565320,2473406,2246713,9274,9091,1514,1817
2019년1분기,골목상권,사평대로26길,서초구,반포4동,503654,8949,5882,372995,130659,239578,264077,4165,4784,3233,2649
2019년2분기,골목상권,사평대로26길,서초구,반포4동,770396,8949,10115,567650,202741,361970,408430,4165,4784,7115,3000
2019년1분기,골목상권,사평대로57길,서초구,반포1동,2872068,11880,14242,2141010,731067,1543289,1328787,5785,6095,7844,6398
2019년2분기,골목상권,사평대로57길,서초구,반포1동,3352246,11880,12049,2501833,850423,1767079,1585170,5785,6095,6278,5771
2019년1분기,골목상권,서초대로15길,서초구,방배4동,1286076,15468,11529,944351,341735,639893,646192,7157,8311,6214,5315
2019년2분기,골목상권,서초대로15길,서초구,방배4동,1537714,15468,9162,1112656,425051,753784,783929,7157,8311,5644,3518
2019년1분기,골목상권,삼성로64길,강남구,대치2동,1703374,18017,8587,1183573,519809,906962,796412,9219,8798,4806,3781
2019년2분기,골목상권,삼성로64길,강남구,대치2동,1834753,18017,26010,1237296,597460,964250,870503,9219,8798,14918,11092
2019년1분기,골목상권,삼성로69길,강남구,대치4동,2609073,22031,9063,1854889,754190,1353049,1256028,10792,11239,4532,4531
2019년2분기,골목상권,삼성로69길,강남구,대치4동,2891289,22031,11237,2015489,875810,1485220,1406071,10792,11239,6265,4972
2019년1분기,골목상권,삼성로75길,강남구,대치4동,3247665,16021,38572,2563921,683753,1765723,1481932,7710,8311,23780,14792
2019년2분기,골목상권,삼성로75길,강남구,대치4동,3821526,16021,39655,2993086,828450,2057703,1763817,7710,8311,25233,14422
2019년1분기,골목상권,여의대방로22나길,동작구,신대방2동,819075,12635,8048,601023,218054,436667,382410,6115,6520,4140,3908
2019년2분기,골목상권,여의대방로22나길,동작구,신대방2동,974266,12635,17606,701624,272643,511891,462380,6115,6520,11183,6423
2019년1분기,골목상권,여의대방로22카길,동작구,신대방2동,1506084,21384,8659,1084643,421452,763129,742963,10251,11133,4341,4318
2019년2분기,골목상권,여의대방로22카길,동작구,신대방2동,1768891,21384,18024,1264897,504002,882112,886785,10251,11133,11520,6504
2019년1분기,골목상권,여의대방로24길,동작구,대방동,1277401,17337,11134,929692,347716,679269,598134,8262,9075,5687,5447
2019년2분기,골목상권,여의대방로24길,동작구,대방동,1552906,17337,19681,1116400,436509,809485,743423,8262,9075,12377,7304
2019년1분기,골목상권,신사로20길,관악구,신사동,837114,14298,934,580931,256194,427522,409597,7135,7163,447,487
2019년2분기,골목상권,신사로20길,관악구,신사동,1035372,14298,3363,707929,327458,527332,508039,7135,7163,2267,1096
2019년1분기,골목상권,신원로3길,관악구,신원동,2781217,21890,2954,1858718,922513,1456925,1324303,10951,10939,1312,1642
2019년2분기,골목상권,신원로3길,관악구,신원동,3271450,21890,2499,2177071,1094393,1689786,1581672,10951,10939,1069,1430
2019년1분기,골목상권,양녕로6길,관악구,중앙동,3363383,23106,3868,2380727,982668,1676227,1687157,11116,11990,1763,2105
2019년2분기,골목상권,양녕로6길,관악구,중앙동,3902737,23106,2490,2746464,1156291,1921275,1981462,11116,11990,1262,1228
2019년1분기,골목상권,서초대로23길,서초구,방배4동,1391438,13709,12434,1044858,346588,697381,694063,6416,7293,7004,5430
2019년2분기,골목상권,서초대로23길,서초구,방배4동,1732764,13709,13211,1283390,449381,851638,881123,6416,7293,8808,4403
2019년1분기,골목상권,서초대로25길,서초구,방배4동,1536101,15257,15329,1168621,367484,765539,770560,7227,8030,8158,7171
2019년2분기,골목상권,서초대로25길,서초구,방배4동,1916700,15257,21807,1439293,477420,934027,982673,7227,8030,14793,7014
2019년1분기,골목상권,서초대로4길,서초구,방배2동,3063157,17339,8265,2227265,835901,1491616,1571543,8029,9310,4724,3541
2019년2분기,골목상권,서초대로4길,서초구,방배2동,3635762,17339,11174,2620801,1014967,1750835,1884925,8029,9310,5079,6095
2019년1분기,골목상권,봉은사로57길,강남구,삼성2동,1507952,12025,10918,1202005,305957,784491,723474,5649,6376,5457,5461
2019년2분기,골목상권,봉은사로57길,강남구,삼성2동,1801198,12025,11412,1431883,369308,914279,886918,5649,6376,7492,3920
2019년1분기,골목상권,봉은사로68길,강남구,삼성2동,1498128,11219,22387,1209710,288429,836281,661846,5377,5842,12802,9585
2019년2분기,골목상권,봉은사로68길,강남구,삼성2동,1960046,11219,26050,1579654,380401,1069292,890760,5377,5842,14721,11329
2019년1분기,골목상권,삼성로115길,강남구,삼성2동,1168510,18779,13806,910827,257687,568945,599559,8909,9870,7127,6679
2019년2분기,골목상권,삼성로115길,강남구,삼성2동,1482344,18779,15288,1149815,332536,722350,760001,8909,9870,9326,5962
2019년1분기,골목상권,여의대방로46길,동작구,대방동,1269738,18230,6852,921258,348471,655523,614212,8759,9471,3846,3006
2019년2분기,골목상권,여의대방로46길,동작구,대방동,1501292,18230,7717,1077160,424140,770721,730581,8759,9471,4507,3210
2019년1분기,골목상권,장승배기로10길,동작구,상도2동,1863477,22474,3313,1347747,515720,924248,939227,10898,11576,1614,1699
2019년2분기,골목상권,장승배기로10길,동작구,상도2동,2221283,22474,3413,1590878,630417,1065322,1155963,10898,11576,2145,1268
2019년1분기,골목상권,장승배기로19길,동작구,노량진2동,1777674,18950,2937,1299866,477812,899770,877901,9403,9547,1442,1495
2019년2분기,골목상권,장승배기로19길,동작구,노량진2동,2057717,18950,1775,1492100,565615,1011514,1046203,9403,9547,914,861
2019년1분기,골목상권,은천로25길,관악구,성현동,1141417,24788,1116,813834,327586,547860,593559,12075,12713,373,743
2019년2분기,골목상권,은천로25길,관악구,성현동,1243723,24788,817,869063,374662,592579,651144,12075,12713,382,435
2019년1분기,골목상권,인헌길,관악구,인헌동,810670,21831,1207,565262,245415,400665,410011,10661,11170,500,707
2019년2분기,골목상권,인헌길,관악구,인헌동,1006575,21831,1959,692307,314271,487108,519472,10661,11170,1087,872
2019년1분기,골목상권,장군봉1길,관악구,청룡동,1948762,16378,3030,1385599,563159,1023507,925257,7998,8380,1349,1681
2019년2분기,골목상권,장군봉1길,관악구,청룡동,2259767,16378,2745,1593722,666068,1153272,1106502,7998,8380,1382,1363
2019년1분기,골목상권,서초대로64길,서초구,서초1동,1286641,16555,13808,977701,308936,673520,613119,8020,8535,7681,6127
2019년2분기,골목상권,서초대로64길,서초구,서초1동,1513789,16555,20650,1140926,372867,782081,731708,8020,8535,12891,7759
2019년1분기,골목상권,서초대로8길,서초구,방배2동,1185463,19352,4549,863811,321658,558078,627383,9052,10300,2740,1809
2019년2분기,골목상권,서초대로8길,서초구,방배2동,1405256,19352,9023,1008464,396799,660421,744840,9052,10300,4380,4643
2019년1분기,골목상권,신반포로45길,서초구,잠원동,1971440,17235,19109,1525200,446238,1090331,881110,8212,9023,11939,7170
2019년2분기,골목상권,신반포로45길,서초구,잠원동,2265803,17235,10753,1769694,496119,1220696,1045102,8212,9023,6415,4338
2019년1분기,골목상권,삼성로147길,강남구,청담동,1343456,11080,14746,1008219,335245,608505,734955,5146,5934,5273,9473
2019년2분기,골목상권,삼성로147길,강남구,청담동,1745604,11080,14517,1308189,437412,768868,976735,5146,5934,7537,6980
2019년1분기,골목상권,삼성로57길,강남구,대치1동,2095568,19967,3854,1407554,688020,1009376,1086195,10009,9958,1573,2281
2019년2분기,골목상권,삼성로57길,강남구,대치1동,2253226,19967,13015,1473032,780203,1069000,1184229,10009,9958,9541,3474
2019년1분기,골목상권,삼성로63길,강남구,대치4동,2682196,20877,5542,1818796,863410,1328414,1353784,10353,10524,2373,3169
2019년2분기,골목상권,삼성로63길,강남구,대치4동,2892865,20877,17197,1906285,986591,1411619,1481248,10353,10524,11593,5604
2019년1분기,골목상권,장승배기로27길,동작구,노량진2동,1898356,13726,8201,1421611,476746,1011889,886468,6968,6758,4705,3496
2019년2분기,골목상권,장승배기로27길,동작구,노량진2동,2031909,13726,6741,1505426,526492,1075737,956171,6968,6758,3867,2874
2019년1분기,골목상권,흑석로13길,동작구,흑석동,3241515,7638,5343,2524830,716672,1651294,1590220,3831,3807,2366,2977
2019년2분기,골목상권,흑석로13길,동작구,흑석동,4325642,7638,983,3413716,911919,2169622,2156015,3831,3807,513,470
2019년1분기,골목상권,흑석로9길,동작구,흑석동,3155371,7514,5224,2473190,682169,1609946,1545424,3777,3737,2326,2898
2019년2분기,골목상권,흑석로9길,동작구,흑석동,4292052,7514,698,3408862,883182,2158544,2133507,3777,3737,356,342
2019년1분기,골목상권,장군봉2길,관악구,청룡동,1519266,12733,2860,1070339,448932,818404,700866,6362,6371,1369,1491
2019년2분기,골목상권,장군봉2길,관악구,청룡동,1740850,12733,2466,1218054,522804,907735,833124,6362,6371,1336,1130
2019년1분기,골목상권,조원로10길,관악구,조원동,3666344,19878,18509,2756154,910188,2083337,1583014,10356,9522,10521,7988
2019년2분기,골목상권,조원로10길,관악구,조원동,4057272,19878,17980,2993421,1063873,2256329,1800961,10356,9522,10118,7862
2019년1분기,골목상권,조원로18길,관악구,조원동,1581773,16156,4695,1103071,478697,823201,758578,8008,8148,3245,1450
2019년2분기,골목상권,조원로18길,관악구,조원동,1858815,16156,5926,1283409,575414,964717,894095,8008,8148,4561,1365
2019년1분기,골목상권,언남길,서초구,양재2동,872971,10147,24278,705475,167494,516660,356311,5217,4930,14400,9878
2019년2분기,골목상권,언남길,서초구,양재2동,1064603,10147,18611,838306,226297,614374,450223,5217,4930,11765,6846
2019년1분기,골목상권,주흥15길,서초구,반포1동,2135711,17211,10761,1585238,550479,1134355,1001361,8254,8957,5844,4917
2019년2분기,골목상권,주흥15길,서초구,반포1동,2470356,17211,10699,1830918,639449,1282243,1188112,8254,8957,5239,5460
2019년1분기,골목상권,주흥길,서초구,반포1동,2325825,18656,11516,1703312,622527,1208041,1117790,8957,9699,7619,3897
2019년2분기,골목상권,주흥길,서초구,반포1동,2702059,18656,4929,1972594,729481,1375772,1326285,8957,9699,2734,2195
2019년1분기,골목상권,영신로9길,영등포구,영등포본동,1682576,17220,2781,1141421,541155,847974,834599,9080,8140,1404,1377
2019년2분기,골목상권,영신로9길,영등포구,영등포본동,1974704,17220,2662,1315250,659466,978097,996606,9080,8140,1667,995
2019년1분기,골목상권,국사봉1길,동작구,상도3동,2105825,24162,2681,1473491,632348,1040636,1065191,11468,12694,1073,1608
2019년2분기,골목상권,국사봉1길,동작구,상도3동,2453677,24162,1828,1698847,754830,1182390,1271285,11468,12694,927,901
2019년1분기,골목상권,국사봉2길,동작구,신대방2동,1551173,19527,2320,1086182,465009,772320,778857,9295,10232,1020,1300
2019년2분기,골목상권,국사봉2길,동작구,신대방2동,1821238,19527,16541,1264190,557050,886718,934525,9295,10232,10676,5865
2019년1분기,골목상권,관악로10길,관악구,낙성대동,2333452,15965,7339,1662599,670864,1218062,1115396,7728,8237,4188,3151
2019년2분기,골목상권,관악로10길,관악구,낙성대동,2699023,15965,6202,1911640,787388,1395211,1303815,7728,8237,3748,2454
2019년1분기,골목상권,관악로14길,관악구,낙성대동,3542717,19044,8102,2511965,1030768,1817075,1725645,9213,9831,4145,3957
2019년2분기,골목상권,관악로14길,관악구,낙성대동,4094246,19044,6542,2892725,1201534,2075017,2019228,9213,9831,3309,3233
2019년1분기,골목상권,관악로28길,관악구,행운동,851552,20934,1959,600167,251380,417140,434415,10252,10682,846,1113
2019년2분기,골목상권,관악로28길,관악구,행운동,1015946,20934,1891,707686,308264,484189,531761,10252,10682,807,1084
2019년1분기,골목상권,조원중앙로2길,관악구,조원동,2081650,22642,5344,1515038,566603,1113079,968579,11317,11325,3599,1745
2019년2분기,골목상권,조원중앙로2길,관악구,조원동,2248935,22642,5980,1578993,669953,1178992,1069951,11317,11325,4243,1737
2019년1분기,골목상권,중앙길,관악구,중앙동,3051193,29516,3162,2146440,904778,1509593,1541609,14360,15156,1311,1851
2019년2분기,골목상권,중앙길,관악구,중앙동,3478570,29516,2016,2428119,1050465,1695438,1783133,14360,15156,995,1021
2019년1분기,골목상권,청룡8길,관악구,청룡동,1913906,14944,2877,1361257,552649,1014566,899338,7371,7573,1259,1618
2019년2분기,골목상권,청룡8길,관악구,청룡동,2208516,14944,2508,1553973,654559,1143254,1065262,7371,7573,1207,1301
2019년1분기,골목상권,청두곶길,서초구,방배2동,1855322,16633,11331,1365735,489592,931177,924142,7867,8766,5072,6259
2019년2분기,골목상권,청두곶길,서초구,방배2동,2247356,16633,13110,1632221,615133,1115035,1132315,7867,8766,6497,6613
2019년1분기,골목상권,효령로23길,서초구,방배1동,1512740,16986,10325,1162585,350160,764379,748362,8076,8910,5508,4817
2019년2분기,골목상권,효령로23길,서초구,방배1동,1852819,16986,13045,1442881,409942,909048,943771,8076,8910,8684,4361
2019년1분기,골목상권,효령로31길,서초구,방배1동,1470427,15728,11706,1130416,340023,749417,721012,7361,8367,5924,5782
2019년2분기,골목상권,효령로31길,서초구,방배1동,1837343,15728,10652,1417733,419617,912142,925206,7361,8367,7146,3506
2019년1분기,골목상권,국사봉길,동작구,상도3동,1647047,27211,1406,1142227,504841,796077,850970,13128,14083,530,876
2019년2분기,골목상권,국사봉길,동작구,상도3동,1980750,27211,1454,1353938,626808,937186,1043563,13128,14083,817,637
2019년1분기,골목상권,노량진로6길,동작구,노량진2동,1360161,16430,6775,1005463,354703,729465,630697,8317,8113,3779,2996
2019년2분기,골목상권,노량진로6길,동작구,노량진2동,1521922,16430,6312,1112619,409307,808881,713038,8317,8113,3608,2704
2019년1분기,골목상권,대방동27길,동작구,대방동,957300,17654,4436,687310,269992,495865,461433,8506,9148,2349,2087
2019년2분기,골목상권,대방동27길,동작구,대방동,1162147,17654,6330,820161,341996,594691,567457,8506,9148,4252,2078
2019년1분기,골목상권,관악로30길,관악구,청림동,887973,25078,2460,626131,261840,438174,449796,12177,12901,1075,1385
2019년2분기,골목상권,관악로30길,관악구,청림동,1051260,25078,2909,732168,319101,500797,550468,12177,12901,1444,1465
2019년1분기,골목상권,관천로15길,관악구,신사동,1065874,24434,3516,738238,327646,544349,521527,12272,12162,2497,1019
2019년2분기,골목상권,관천로15길,관악구,신사동,1323200,24434,3932,902980,420227,668497,654700,12272,12162,2599,1333
2019년1분기,골목상권,관천로22길,관악구,신림동,1828202,23692,11990,1280824,547378,947751,880451,11834,11858,6413,5577
2019년2분기,골목상권,관천로22길,관악구,신림동,2218952,23692,4600,1537366,681600,1123628,1095327,11834,11858,2514,2086
2019년1분기,골목상권,청룡길,관악구,청룡동,2992221,23569,3781,2118161,874048,1525862,1466351,11337,12232,1995,1786
2019년2분기,골목상권,청룡길,관악구,청룡동,3405631,23569,3280,2397019,1008625,1717070,1688566,11337,12232,1614,1666
2019년1분기,골목상권,청림3길,관악구,청림동,1079483,33889,2059,768564,310925,542582,536899,16512,17377,920,1139
2019년2분기,골목상권,청림3길,관악구,청림동,1206028,33889,3413,850271,355775,594908,611122,16512,17377,1832,1581
2019년1분기,골목상권,행운1길,관악구,행운동,3468662,18859,4694,2430575,1038087,1745535,1723130,9302,9557,2260,2434
2019년2분기,골목상권,행운1길,관악구,행운동,4028128,18859,2967,2819441,1208701,1993644,2034481,9302,9557,1557,1410
2019년1분기,골목상권,효령로34길,서초구,방배3동,1007925,8446,7160,777747,230183,512837,495088,4151,4295,4263,2897
2019년2분기,골목상권,효령로34길,서초구,방배3동,1316521,8446,8829,1029187,287340,647351,669171,4151,4295,5689,3140
2019년1분기,골목상권,효령로72길,서초구,서초2동,1301060,8984,14096,1050223,250852,743469,557594,4360,4624,9233,4863
2019년2분기,골목상권,효령로72길,서초구,서초2동,1485084,8984,28079,1195905,289180,848176,636915,4360,4624,21029,7050
2019년1분기,골목상권,방배중앙로21길,서초구,방배본동,1215633,16232,5186,870313,345321,619565,596066,7508,8724,2757,2429
2019년2분기,골목상권,방배중앙로21길,서초구,방배본동,1462461,16232,12909,1029604,432852,717503,744954,7508,8724,5920,6989
2019년1분기,골목상권,대방동2길,동작구,대방동,1322361,16853,3084,939617,382757,663203,659163,8018,8835,1436,1648
2019년2분기,골목상권,대방동2길,동작구,대방동,1544525,16853,16869,1086600,457945,764487,780038,8018,8835,10771,6098
2019년1분기,골목상권,동작대로17길,동작구,사당1동,2977960,17466,6906,2148186,829795,1517766,1460196,8223,9243,3711,3195
2019년2분기,골목상권,동작대로17길,동작구,사당1동,3450216,17466,5580,2472887,977349,1727184,1723042,8223,9243,3085,2495
2019년1분기,골목상권,동작대로29길,동작구,사당2동,1754135,18630,1969,1236988,517154,905637,848498,8906,9724,900,1069
2019년2분기,골목상권,동작대로29길,동작구,사당2동,2047877,18630,1281,1432491,615386,1033082,1014805,8906,9724,639,642
2019년1분기,골목상권,구암길,관악구,성현동,955843,27453,1191,680246,275591,461966,493873,13426,14027,449,742
2019년2분기,골목상권,구암길,관악구,성현동,1096803,27453,831,765534,331273,525099,571701,13426,14027,403,428
2019년1분기,골목상권,국회단지길,관악구,은천동,1579037,27329,1927,1088200,490837,805654,773378,13477,13852,867,1060
2019년2분기,골목상권,국회단지길,관악구,은천동,1823663,27329,5486,1241738,581923,899872,923793,13477,13852,2157,3329
2019년1분기,골목상권,낙성대역길,관악구,인헌동,2304204,21182,5000,1610120,694098,1186324,1117885,10282,10900,2827,2173
2019년2분기,골목상권,낙성대역길,관악구,인헌동,2683155,21182,5197,1866659,816498,1345370,1337791,10282,10900,3075,2122
2019년1분기,골목상권,행운길,관악구,행운동,2816121,24803,4922,1946704,869415,1437864,1378257,12099,12704,2601,2321
2019년2분기,골목상권,행운길,관악구,행운동,3258980,24803,5569,2248108,1010873,1629215,1629767,12099,12704,3260,2309
2019년1분기,골목상권,호암로20길,관악구,대학동,2720888,19326,1601,1920005,800882,1642271,1078622,11376,7950,732,869
2019년2분기,골목상권,호암로20길,관악구,대학동,3277515,19326,2140,2285113,992391,1958931,1318587,11376,7950,1606,534
2019년1분기,골목상권,호암로24길,관악구,대학동,3219625,19523,3062,2276091,943540,1932632,1287001,11620,7903,1826,1236
2019년2분기,골목상권,호암로24길,관악구,대학동,3651286,19523,2532,2547450,1103820,2168654,1482641,11620,7903,1846,686
2019년1분기,골목상권,서초중앙로8길,서초구,서초1동,1746784,15333,22771,1368008,378777,946051,800724,7459,7874,13603,9168
2019년2분기,골목상권,서초중앙로8길,서초구,서초1동,2026927,15333,21908,1581647,445283,1069686,957239,7459,7874,13370,8538
2019년1분기,골목상권,강남대로118길,강남구,논현1동,1623375,14223,9000,1188864,434521,874496,748886,6624,7599,5113,3887
2019년2분기,골목상권,강남대로118길,강남구,논현1동,1887213,14223,10119,1391704,495515,997268,889948,6624,7599,6479,3640
2019년1분기,골목상권,강남대로136길,강남구,논현1동,1984224,10475,29345,1584437,399786,1089835,894391,4844,5631,15965,13380
2019년2분기,골목상권,강남대로136길,강남구,논현1동,2389611,10475,27582,1918990,470621,1290699,1098904,4844,5631,15223,12359
2019년1분기,골목상권,동작대로33길,동작구,사당2동,2500794,22484,4384,1788361,712441,1253029,1247764,10722,11762,1729,2655
2019년2분기,골목상권,동작대로33길,동작구,사당2동,2990674,22484,11983,2126459,864222,1460430,1530250,10722,11762,5014,6969
2019년1분기,골목상권,동작대로35길,동작구,사당2동,992114,20432,3055,705491,286625,480199,511908,9765,10667,1457,1598
2019년2분기,골목상권,동작대로35길,동작구,사당2동,1174439,20432,10868,826280,348155,553511,620929,9765,10667,4646,6222
2019년1분기,골목상권,동작대로7길,동작구,사당1동,2983959,20251,6622,2138114,845862,1554638,1429330,9676,10575,3687,2935
2019년2분기,골목상권,동작대로7길,동작구,사당1동,3445745,20251,7677,2464514,981230,1775541,1670208,9676,10575,4249,3428
2019년1분기,골목상권,난곡로24길,관악구,난곡동,402894,15033,987,273472,129425,219733,183170,7644,7389,435,552
2019년2분기,골목상권,난곡로24길,관악구,난곡동,502262,15033,1312,336204,166064,259189,243075,7644,7389,728,584
2019년1분기,골목상권,난곡로26길,관악구,난곡동,819877,18423,1038,574021,245854,428831,391052,9337,9086,406,632
2019년2분기,골목상권,난곡로26길,관악구,난곡동,975187,18423,1205,673255,301936,497157,478035,9337,9086,654,551
2019년1분기,골목상권,난곡로34길,관악구,난곡동,1169722,20018,1172,816983,352729,599770,569963,10014,10004,463,709
2019년2분기,골목상권,난곡로34길,관악구,난곡동,1382482,20018,967,951476,431021,701821,680670,10014,10004,488,479
2019년1분기,골목상권,양산길,관악구,삼성동,1265655,15184,1570,902831,362846,706995,558667,7752,7432,821,749
2019년2분기,골목상권,양산길,관악구,삼성동,1412022,15184,729,983194,428828,781443,630585,7752,7432,374,355
2019년1분기,골목상권,양지길,관악구,삼성동,1264396,11903,1522,905255,359147,716806,547597,6256,5647,796,726
2019년2분기,골목상권,양지길,관악구,삼성동,1477015,11903,402,1029458,447556,828523,648502,6256,5647,168,234
2019년1분기,골목상권,원신길,관악구,삼성동,384345,12620,690,268242,116094,202137,182204,6492,6128,280,410
2019년2분기,골목상권,원신길,관악구,삼성동,701888,12620,727,486207,215680,391471,310419,6492,6128,377,350
2019년1분기,골목상권,강남대로140길,강남구,논현1동,2027070,5291,26152,1586647,440425,1075449,951624,2393,2898,12762,13390
2019년2분기,골목상권,강남대로140길,강남구,논현1동,2404773,5291,26412,1904095,500687,1268940,1135837,2393,2898,13779,12633
2019년1분기,골목상권,개포로17길,강남구,개포4동,911510,12114,24838,716807,194699,542686,368823,5901,6213,13714,11124
2019년2분기,골목상권,개포로17길,강남구,개포4동,1105326,12114,31977,857673,247653,622423,482911,5901,6213,13405,18572
2019년1분기,골목상권,개포로20길,강남구,개포4동,1075101,12431,23049,845912,229197,640750,434355,6207,6224,12909,10140
2019년2분기,골목상권,개포로20길,강남구,개포4동,1291873,12431,17163,1002381,289496,736591,555284,6207,6224,9905,7258
2019년1분기,골목상권,등용로14길,동작구,대방동,1102819,14855,7920,830119,272700,603070,499750,7269,7586,4565,3355
2019년2분기,골목상권,등용로14길,동작구,대방동,1207705,14855,7740,898193,309515,657798,549906,7269,7586,4661,3079
2019년1분기,골목상권,만양로14길,동작구,노량진1동,2086816,12817,2545,1470011,616805,1197468,889346,6516,6301,1474,1071
2019년2분기,골목상권,만양로14길,동작구,노량진1동,2362620,12817,2069,1633289,729329,1337996,1024629,6516,6301,1080,989
2019년1분기,골목상권,만양로8길,동작구,노량진1동,2324609,24396,1965,1617706,706904,1282815,1041790,12080,12316,846,1119
2019년2분기,골목상권,만양로8길,동작구,노량진1동,2605375,24396,4532,1778717,826665,1420371,1185011,12080,12316,2761,1771
2019년1분기,골목상권,난곡로74길,관악구,신사동,1304137,15136,2722,900166,403983,666160,637985,7484,7652,1873,849
2019년2분기,골목상권,난곡로74길,관악구,신사동,1584923,15136,4511,1082008,502933,811915,773012,7484,7652,3556,955
2019년1분기,골목상권,난우길,관악구,미성동,1086064,20596,1830,765454,320613,545870,540197,10137,10459,796,1034
2019년2분기,골목상권,난우길,관악구,미성동,1333062,20596,1341,923431,409635,660402,672663,10137,10459,639,702
2019년1분기,골목상권,난향길,관악구,난향동,247886,12031,1128,178254,69635,121167,126724,6028,6003,471,657
2019년2분기,골목상권,난향길,관악구,난향동,317407,12031,1946,219947,97462,154657,162746,6028,6003,948,998
2019년1분기,골목상권,소담길,관악구,청룡동,1510126,18251,1194,1065883,444250,830070,680053,9237,9014,611,583
2019년2분기,골목상권,소담길,관악구,청룡동,1726950,18251,1124,1200329,526622,925847,801094,9237,9014,583,541
2019년1분기,골목상권,강남대로23길,서초구,양재1동,521112,4776,15708,429691,91423,307888,213230,2254,2522,9580,6128
2019년2분기,골목상권,강남대로23길,서초구,양재1동,675168,4776,19777,545274,129899,388456,286706,2254,2522,12359,7418
2019년1분기,골목상권,강남대로34길,서초구,양재1동,1781615,9505,24660,1402157,379454,983563,798044,4542,4963,13588,11072
2019년2분기,골목상권,강남대로34길,서초구,양재1동,2148179,9505,22589,1682070,466107,1166300,981872,4542,4963,14461,8128
2019년1분기,골목상권,개포로28길,강남구,개포4동,777993,10500,6377,600751,177250,457315,320678,5150,5350,3646,2731
2019년2분기,골목상권,개포로28길,강남구,개포4동,928769,10500,4647,706907,221867,520411,408360,5150,5350,2997,1650
2019년1분기,골목상권,개포로82길,강남구,개포2동,109774,7192,1055,81028,28750,53379,56395,3464,3728,434,621
2019년2분기,골목상권,개포로82길,강남구,개포2동,155266,7192,4987,109595,45668,72603,82664,3464,3728,3716,1271
2019년1분기,골목상권,남부순환로365길,강남구,도곡1동,1455595,18650,15492,1120045,335542,798594,656995,8834,9816,8151,7341
2019년2분기,골목상권,남부순환로365길,강남구,도곡1동,1750594,18650,18776,1347549,403040,939827,810761,8834,9816,11937,6839
2019년1분기,골목상권,사당로16가길,동작구,사당4동,1471408,19474,2629,1048855,422564,734244,737167,9296,10178,1295,1334
2019년2분기,골목상권,사당로16가길,동작구,사당4동,1758966,19474,2588,1244204,514775,853045,905919,9296,10178,1425,1163
2019년1분기,골목상권,사당로16길,동작구,사당4동,1807802,25937,2527,1282372,525461,902729,905081,12526,13411,1311,1216
2019년2분기,골목상권,사당로16길,동작구,사당4동,2128247,25937,2679,1496717,631550,1039892,1088359,12526,13411,1519,1160
2019년1분기,골목상권,사당로20길,동작구,사당1동,1622376,21647,2778,1145930,476468,813441,808950,10408,11239,1429,1349
2019년2분기,골목상권,사당로20길,동작구,사당1동,1895205,21647,2201,1328688,566531,937659,957550,10408,11239,1335,866
2019년1분기,골목상권,남부순환로142길,관악구,미성동,1273816,19302,4647,893456,380377,657195,616623,9527,9775,3160,1487
2019년2분기,골목상권,남부순환로142길,관악구,미성동,1487824,19302,4960,1031349,456482,763945,723879,9527,9775,3467,1493
2019년1분기,골목상권,남부순환로151길,관악구,신사동,1563939,20133,3442,1086322,477629,810799,753152,9961,10172,1746,1696
2019년2분기,골목상권,남부순환로151길,관악구,신사동,1833286,20133,4960,1260060,573234,952400,880887,9961,10172,3441,1519
2019년1분기,골목상권,남부순환로161길,관악구,신사동,1306622,22343,2866,907386,399265,680096,626535,11244,11099,1432,1434
2019년2분기,골목상권,남부순환로161길,관악구,신사동,1569844,22343,4516,1078167,491685,809295,760553,11244,11099,3110,1406
2019년1분기,골목상권,강남대로8길,서초구,양재2동,775180,9879,93247,592945,182239,458701,316478,4940,4939,83334,9913
2019년2분기,골목상권,강남대로8길,서초구,양재2동,979828,9879,85264,736348,243486,570739,409090,4940,4939,76488,8776
2019년1분기,골목상권,고무래로8길,서초구,반포4동,1019992,16412,31663,765975,254024,487032,532963,8000,8412,12922,18741
2019년2분기,골목상권,고무래로8길,서초구,반포4동,1198087,16412,16992,885030,313055,565199,632886,8000,8412,11435,5557
2019년1분기,골목상권,남부순환로317길,서초구,서초3동,1544406,11085,14323,1180124,364294,815003,729403,5428,5657,8680,5643
2019년2분기,골목상권,남부순환로317길,서초구,서초3동,1771265,11085,20952,1345435,425834,916293,854974,5428,5657,13375,7577
2019년1분기,골목상권,논현로106길,강남구,역삼1동,2258251,8904,27586,1790236,468014,1233328,1024917,4185,4719,15747,11839
2019년2분기,골목상권,논현로106길,강남구,역삼1동,2680041,8904,14559,2120987,559069,1431853,1248186,4185,4719,8201,6358
2019년1분기,골목상권,논현로10길,강남구,개포4동,790746,13467,10346,619033,171716,454172,336577,6625,6842,5713,4633
2019년2분기,골목상권,논현로10길,강남구,개포4동,989977,13467,6728,759724,230254,554879,435092,6625,6842,3828,2900
2019년1분기,골목상권,논현로115길,강남구,논현1동,2630921,14907,25530,2005504,625438,1390972,1239950,6958,7949,13893,11637
2019년2분기,골목상권,논현로115길,강남구,논현1동,3135998,14907,22705,2398889,737118,1614800,1521196,6958,7949,14815,7890
2019년1분기,골목상권,사당로23길,동작구,사당3동,502269,21794,872,351740,150532,238987,263280,10548,11246,377,495
2019년2분기,골목상권,사당로23길,동작구,사당3동,626029,21794,13107,427698,198330,293070,332958,10548,11246,4362,8745
2019년1분기,골목상권,사당로23나길,동작구,사당3동,748583,17240,1543,527184,221403,361493,387093,8285,8955,670,873
2019년2분기,골목상권,사당로23나길,동작구,사당3동,891799,17240,845,620292,271508,419407,472392,8285,8955,394,451
2019년1분기,골목상권,사당로26길,동작구,사당1동,1879097,18153,3337,1347767,531344,951487,927619,8717,9436,1786,1551
2019년2분기,골목상권,사당로26길,동작구,사당1동,2201950,18153,3024,1570668,631287,1099275,1102680,8717,9436,1706,1318
2019년1분기,골목상권,남부순환로172길,관악구,미성동,1953979,20260,2780,1334983,619008,1037407,916581,10096,10164,1365,1415
2019년2분기,골목상권,남부순환로172길,관악구,미성동,2384811,20260,2016,1615847,768975,1254138,1130674,10096,10164,1192,824
2019년1분기,골목상권,남부순환로234길,관악구,낙성대동,1748962,12958,3661,1201401,547565,898471,850496,6430,6528,2173,1488
2019년2분기,골목상권,남부순환로234길,관악구,낙성대동,2025235,12958,3074,1387695,637541,1023375,1001858,6430,6528,1859,1215
2019년1분기,골목상권,남부순환로248길,관악구,인헌동,1137973,18856,2021,802809,335181,556495,581483,9091,9765,913,1108
2019년2분기,골목상권,남부순환로248길,관악구,인헌동,1359536,18856,2154,949796,409746,654675,704863,9091,9765,1155,999
2019년1분기,골목상권,남부순환로325길,서초구,서초3동,1807569,9634,21170,1393347,414224,970452,837117,4647,4987,13364,7806
2019년2분기,골목상권,남부순환로325길,서초구,서초3동,2047664,9634,23106,1570410,477261,1079397,968263,4647,4987,13802,9304
2019년1분기,골목상권,남부순환로339길,서초구,서초1동,799298,8960,23689,643157,156148,460355,338938,4359,4601,12943,10746
2019년2분기,골목상권,남부순환로339길,서초구,서초1동,935845,8960,11863,748301,187536,529345,406504,4359,4601,6444,5419
2019년1분기,골목상권,논현로1길,서초구,양재2동,732774,14588,12871,568811,163962,417316,315450,7224,7364,7855,5016
2019년2분기,골목상권,논현로1길,서초구,양재2동,911259,14588,10695,693665,217589,512850,398404,7224,7364,6765,3930
2019년1분기,골목상권,논현로123길,강남구,논현1동,921997,12198,9297,699262,222747,496352,425649,5645,6553,5343,3954
2019년2분기,골목상권,논현로123길,강남구,논현1동,1160673,12198,9753,875608,285064,604873,555796,5645,6553,5955,3798
2019년1분기,골목상권,논현로139길,강남구,논현1동,1752421,7159,32163,1376014,376406,912646,839780,3289,3870,16232,15931
2019년2분기,골목상권,논현로139길,강남구,논현1동,2113935,7159,25238,1655480,458460,1085051,1028882,3289,3870,14362,10876
2019년1분기,골목상권,논현로159길,강남구,신사동,1806419,6402,17546,1335052,471377,789791,1016633,2872,3530,7679,9867
2019년2분기,골목상권,논현로159길,강남구,신사동,2257174,6402,7485,1650828,606341,982767,1274401,2872,3530,3505,3980
2019년1분기,골목상권,사당로29길,동작구,사당3동,2776754,16002,4611,1989182,787588,1440579,1336179,7710,8292,2180,2431
2019년2분기,골목상권,사당로29길,동작구,사당3동,3247304,16002,2526,2310803,936513,1641002,1606311,7710,8292,1239,1287
2019년1분기,골목상권,사당로2차길,동작구,사당5동,493994,13613,1432,356017,137986,247927,246065,6581,7032,692,740
2019년2분기,골목상권,사당로2차길,동작구,사당5동,621715,13613,2179,444330,177390,301111,320609,6581,7032,1452,727
2019년1분기,골목상권,사당로30길,동작구,사당1동,2447018,13004,5738,1783783,663247,1224297,1222722,6146,6858,3375,2363
2019년2분기,골목상권,사당로30길,동작구,사당1동,2802219,13004,4778,2035531,766693,1383514,1418708,6146,6858,2722,2056
2019년1분기,골목상권,남현2길,관악구,남현동,1688676,22945,3754,1187382,501313,877924,810760,10991,11954,1873,1881
2019년2분기,골목상권,남현2길,관악구,남현동,1996482,22945,4016,1396719,599764,1010899,985589,10991,11954,2615,1401
2019년1분기,골목상권,남현3길,관악구,남현동,2010719,14478,5958,1421759,588969,1063823,946905,6851,7627,3352,2606
2019년2분기,골목상권,남현3길,관악구,남현동,2373728,14478,6766,1678308,695409,1228280,1145449,6851,7627,3909,2857
2019년1분기,골목상권,남현길,관악구,남현동,1295187,16171,2900,905377,389824,675821,619364,7741,8430,1513,1387
2019년2분기,골목상권,남현길,관악구,남현동,1536943,16171,3537,1071007,465934,775914,761037,7741,8430,2297,1240
2019년1분기,골목상권,논현로27길,서초구,양재1동,1150673,8794,32189,932407,218267,649938,500737,4291,4503,19800,12389
2019년2분기,골목상권,논현로27길,서초구,양재1동,1409165,8794,46436,1125597,283571,780675,628482,4291,4503,23315,23121
2019년1분기,골목상권,동광로12길,서초구,방배4동,3203650,19683,9370,2316148,887515,1582300,1621368,8921,10762,5513,3857
2019년2분기,골목상권,동광로12길,서초구,방배4동,3773422,19683,16774,2706236,1067196,1828671,1944755,8921,10762,8164,8610
2019년1분기,골목상권,동광로1길,서초구,방배본동,959680,17884,6787,701987,257694,492599,467079,8344,9540,3720,3067
2019년2분기,골목상권,동광로1길,서초구,방배본동,1221132,17884,15047,878217,342912,608198,612932,8344,9540,6360,8687
2019년1분기,골목상권,논현로26길,강남구,도곡2동,1133817,11062,40485,898167,235646,635930,497886,5294,5768,18837,21648
2019년2분기,골목상권,논현로26길,강남구,도곡2동,1381665,11062,44511,1080915,300746,749639,632027,5294,5768,22711,21800
2019년1분기,골목상권,논현로28길,강남구,도곡2동,1092886,9319,31357,859594,233298,595332,497550,4380,4939,13438,17919
2019년2분기,골목상권,논현로28길,강남구,도곡2동,1353262,9319,45634,1050462,302795,721432,631828,4380,4939,23984,21650
2019년1분기,골목상권,논현로63길,강남구,역삼1동,1599082,17485,20787,1268472,330608,904653,694427,8377,9108,11792,8995
2019년2분기,골목상권,논현로63길,강남구,역삼1동,1795906,17485,32015,1420581,375331,982169,813732,8377,9108,23227,8788
2019년1분기,골목상권,사당로8길,동작구,사당5동,1296155,22240,2137,909383,386777,635197,660951,10705,11535,1059,1078
2019년2분기,골목상권,사당로8길,동작구,사당5동,1557786,22240,3286,1085637,472153,740085,817705,10705,11535,2034,1252
2019년1분기,골목상권,상도로15길,동작구,상도2동,2093249,24541,3144,1500120,593125,1046353,1046892,11863,12678,1245,1899
2019년2분기,골목상권,상도로15길,동작구,상도2동,2455109,24541,1998,1743949,711160,1192612,1262500,11863,12678,920,1078
2019년1분기,골목상권,상도로37길,동작구,상도1동,1414312,18777,1753,994814,419495,706687,707626,9145,9632,852,901
2019년2분기,골목상권,상도로37길,동작구,상도1동,1590291,18777,2367,1095471,494812,776812,813473,9145,9632,1135,1232
2019년1분기,골목상권,당곡길,관악구,보라매동,1427394,21414,9937,1017143,410254,726098,701302,10586,10828,4585,5352
2019년2분기,골목상권,당곡길,관악구,보라매동,1707550,21414,2870,1207331,500246,850398,857157,10586,10828,1609,1261
2019년1분기,골목상권,대학14길,관악구,대학동,1107208,15749,610,771817,335399,688379,418824,9587,6162,308,302
2019년2분기,골목상권,대학14길,관악구,대학동,1351332,15749,1117,938324,412996,834454,516874,9587,6162,644,473
2019년1분기,골목상권,대학길,관악구,대학동,2077224,17601,1794,1456614,620603,1291806,785416,10842,6759,1148,646
2019년2분기,골목상권,대학길,관악구,대학동,2332927,17601,2196,1623405,709500,1433239,899687,10842,6759,1683,513
