yesrSe,sgSeCdName,sgCdName,guName,dongName,totalFlowPop,totalStayPop,totalOffPop,menFlowCnt,womenFlowCnt,weekdayFlowCnt,주말_유동인구_수,menStayCnt,womenStayCnt,menOffRaitoCnt,womenOffCnt
2019년1분기,골목상권,계동길,종로구,가회동,118266,1806,348,61268,56997,86815,31451,851,955,142,206
2019년2분기,골목상권,계동길,종로구,가회동,167204,1806,609,82096,85105,118416,48780,851,955,224,385
2019년1분기,골목상권,난계로27길,종로구,숭인2동,246619,841,486,147358,99261,156385,90234,383,458,254,232
2019년2분기,골목상권,난계로27길,종로구,숭인2동,303115,841,348,179132,123984,183408,119707,383,458,159,189
2019년1분기,골목상권,돈화문로11가길,종로구,종로1.2.3.4가동,144480,1214,4822,80073,64407,107665,36815,682,532,2188,2634
2019년2분기,골목상권,돈화문로11가길,종로구,종로1.2.3.4가동,166335,1214,3804,92175,74159,123490,42846,682,532,2773,1031
2019년1분기,골목상권,옥인길,종로구,청운효자동,166390,2586,101,70339,96051,121377,45018,1163,1423,56,45
2019년2분기,골목상권,옥인길,종로구,청운효자동,162345,2586,85,60156,102190,119519,42824,1163,1423,48,37
2019년1분기,골목상권,율곡로10길,종로구,종로1.2.3.4가동,65518,249,615,33437,32080,46747,18769,147,102,353,262
2019년2분기,골목상권,율곡로10길,종로구,종로1.2.3.4가동,86500,249,351,45690,40810,60395,26106,147,102,224,127
2019년1분기,골목상권,율곡로16길,종로구,종로5.6가동,114734,469,567,66222,48514,93322,21413,251,218,371,196
2019년2분기,골목상권,율곡로16길,종로구,종로5.6가동,173527,469,319,95209,78319,142674,30849,251,218,204,115
2019년1분기,골목상권,이화장길,종로구,이화동,189535,1644,1158,94669,94864,140519,49015,801,843,567,591
2019년2분기,골목상권,이화장길,종로구,이화동,235004,1644,540,114830,120174,175034,59964,801,843,236,304
2019년1분기,골목상권,자하문로7길,종로구,사직동,171761,699,457,77098,94666,126591,45170,319,380,223,234
2019년2분기,골목상권,자하문로7길,종로구,사직동,231998,699,507,98232,133767,169197,62804,319,380,243,264
2019년1분기,골목상권,종로24길,종로구,종로1.2.3.4가동,79936,45,1898,48710,31227,62341,17597,32,13,1282,616
2019년2분기,골목상권,종로24길,종로구,종로1.2.3.4가동,98948,45,1123,58504,40443,77341,21606,32,13,778,345
2019년1분기,골목상권,종로58가길,종로구,숭인2동,258647,461,331,126652,131995,193631,65015,246,215,152,179
2019년2분기,골목상권,종로58가길,종로구,숭인2동,289526,461,170,140704,148821,217309,72218,246,215,87,83
2019년1분기,골목상권,명륜길,종로구,혜화동,322387,1453,104,155635,166753,248361,74025,711,742,58,46
2019년2분기,골목상권,명륜길,종로구,혜화동,427927,1453,42,203359,224566,334022,93904,711,742,29,13
2019년1분기,골목상권,백석동길,종로구,부암동,23622,1694,1080,10781,12848,14580,9041,826,868,692,388
2019년2분기,골목상권,백석동길,종로구,부암동,38578,1694,1686,18737,19842,23307,15276,826,868,1005,681
2019년1분기,골목상권,북촌로11길,종로구,가회동,55609,663,493,27469,28140,39445,16166,301,362,197,296
2019년2분기,골목상권,북촌로11길,종로구,가회동,78721,663,501,36875,41846,54713,24011,301,362,186,315
2019년1분기,골목상권,북촌로5길,종로구,삼청동,55288,451,443,23456,31831,36402,18884,209,242,163,280
2019년2분기,골목상권,북촌로5길,종로구,삼청동,82469,451,548,34914,47554,53151,29318,209,242,431,117
2019년1분기,골목상권,북촌로5나길,종로구,삼청동,24978,682,417,12687,12289,16957,8020,324,358,178,239
2019년2분기,골목상권,북촌로5나길,종로구,삼청동,31886,682,235,16388,15498,21870,10014,324,358,118,117
2019년1분기,골목상권,삼청로5길,종로구,삼청동,24235,759,396,12915,11320,17724,6512,340,419,171,225
2019년2분기,골목상권,삼청로5길,종로구,삼청동,33155,759,2709,17668,15487,23127,10028,340,419,2629,80
2019년1분기,골목상권,성균관로5길,종로구,혜화동,261657,947,220,133253,128405,186069,75591,458,489,114,106
2019년2분기,골목상권,성균관로5길,종로구,혜화동,327120,947,169,167415,159704,232813,94308,458,489,91,78
2019년1분기,골목상권,숭인동길,종로구,숭인2동,79384,1770,380,41436,37948,58612,20772,886,884,129,251
2019년2분기,골목상권,숭인동길,종로구,숭인2동,102802,1770,352,55202,47599,76097,26706,886,884,153,199
2019년1분기,골목상권,통일로12길,종로구,교남동,138003,925,89,61691,76310,95679,42319,433,492,36,53
2019년2분기,골목상권,통일로12길,종로구,교남동,172326,925,7,77941,94386,116281,56047,433,492,4,3
2019년1분기,골목상권,평창길,종로구,평창동,328,1787,510,76,254,281,49,882,905,207,303
2019년2분기,골목상권,평창길,종로구,평창동,873,1787,2679,232,642,685,185,882,905,1515,1164
2019년1분기,골목상권,필운대로1길,종로구,사직동,44522,722,609,21103,23419,33137,11385,323,399,363,246
2019년2분기,골목상권,필운대로1길,종로구,사직동,54087,722,244,24050,30039,39990,14098,323,399,79,165
2019년1분기,골목상권,동호로8길,중구,약수동,94176,697,487,47365,46810,69388,24786,329,368,248,239
2019년2분기,골목상권,동호로8길,중구,약수동,109258,697,273,54538,54719,79616,29642,329,368,116,157
2019년1분기,골목상권,명동길,중구,명동,117210,531,18565,56344,60867,88112,29096,36,495,9424,9141
2019년2분기,골목상권,명동길,중구,명동,148751,531,7051,70254,78497,110971,37778,36,495,4474,2577
2019년1분기,골목상권,삼일대로4길,중구,을지로동,181636,107,3801,101069,80567,149948,31686,63,44,1992,1809
2019년2분기,골목상권,삼일대로4길,중구,을지로동,215800,107,1704,117764,98035,177527,38275,63,44,1211,493
2019년1분기,골목상권,장충단로8길,중구,장충동,117121,1480,890,63644,53478,89453,27669,746,734,520,370
2019년2분기,골목상권,장충단로8길,중구,장충동,148380,1480,3859,80767,67613,113384,34996,746,734,1945,1914
2019년1분기,골목상권,청구로17길,중구,다산동,206109,1792,669,104084,102026,157068,49035,890,902,347,322
2019년2분기,골목상권,청구로17길,중구,다산동,243100,1792,523,121656,121445,183700,59400,890,902,344,179
2019년1분기,골목상권,청구로1길,중구,청구동,118226,2037,102,57588,60642,86580,31649,952,1085,53,49
2019년2분기,골목상권,청구로1길,중구,청구동,142350,2037,91,71160,71190,103565,38783,952,1085,71,20
2019년1분기,골목상권,난계로11길,중구,황학동,375649,3351,723,183709,191940,276803,98844,1566,1785,401,322
2019년2분기,골목상권,난계로11길,중구,황학동,466332,3351,310,222752,243580,343206,123126,1566,1785,193,117
2019년1분기,골목상권,난계로21길,중구,황학동,129488,1076,301,61947,67543,89857,39634,531,545,180,121
2019년2분기,골목상권,난계로21길,중구,황학동,166483,1076,124,79454,87031,115202,51276,531,545,85,39
2019년1분기,골목상권,다산로33길,중구,신당동,328795,3551,488,170565,158231,240419,88379,1783,1768,260,228
2019년2분기,골목상권,다산로33길,중구,신당동,390398,3551,354,207028,183371,283550,106851,1783,1768,218,136
2019년1분기,골목상권,다산로36길,중구,동화동,143031,2022,396,72048,70987,103900,39136,993,1029,208,188
2019년2분기,골목상권,다산로36길,중구,동화동,170147,2022,107,84638,85506,121438,48706,993,1029,45,62
2019년1분기,골목상권,다산로38길,중구,동화동,405796,1436,776,213760,192039,294176,111618,685,751,423,353
2019년2분기,골목상권,다산로38길,중구,동화동,487945,1436,492,254444,233503,351770,136174,685,751,213,279
2019년1분기,골목상권,다산로39길,중구,신당동,429601,875,234,229003,200599,333610,95995,492,383,99,135
2019년2분기,골목상권,다산로39길,중구,신당동,484314,875,49,258137,226172,367812,116500,492,383,22,27
2019년1분기,골목상권,동호로10길,중구,청구동,467098,2072,2116,229190,237908,343018,124086,986,1086,1397,719
2019년2분기,골목상권,동호로10길,중구,청구동,534631,2072,1597,261836,272796,392161,142469,986,1086,859,738
2019년1분기,골목상권,동호로11길,중구,다산동,165863,4601,305,82181,83684,119070,46794,2259,2342,168,137
2019년2분기,골목상권,동호로11길,중구,다산동,192838,4601,354,96408,96428,137556,55278,2259,2342,239,115
2019년1분기,골목상권,동호로15길,중구,다산동,176670,1877,1963,90962,85707,133223,43447,906,971,907,1056
2019년2분기,골목상권,동호로15길,중구,다산동,196600,1877,915,102429,94175,146487,50109,906,971,567,348
2019년1분기,골목상권,동호로20길,중구,장충동,143778,2114,1042,74890,68888,107767,36005,1003,1111,715,327
2019년2분기,골목상권,동호로20길,중구,장충동,180133,2114,1860,90964,89168,132621,47512,1003,1111,879,981
2019년1분기,골목상권,종로65길,종로구,숭인2동,273433,3627,227,141344,132087,199090,74343,1873,1754,106,121
2019년2분기,골목상권,종로65길,종로구,숭인2동,326584,3627,261,167073,159511,238430,88152,1873,1754,151,110
2019년1분기,골목상권,지봉로8길,종로구,숭인1동,340028,2307,254,172393,167634,245943,94093,1163,1144,118,136
2019년2분기,골목상권,지봉로8길,종로구,숭인1동,403511,2307,198,203991,199521,280729,122786,1163,1144,101,97
2019년1분기,골목상권,창경궁로35길,종로구,혜화동,116819,924,485,54896,61924,79765,37055,413,511,344,141
2019년2분기,골목상권,창경궁로35길,종로구,혜화동,143021,924,134,65820,77201,96661,46363,413,511,65,69
2019년1분기,골목상권,창신2길,종로구,창신2동,78024,802,120,37704,40321,56487,21537,414,388,56,64
2019년2분기,골목상권,창신2길,종로구,창신2동,89052,802,61,43209,45840,63488,25561,414,388,26,35
2019년1분기,골목상권,창신5길,종로구,창신2동,223109,1293,50,114968,108142,157172,65940,695,598,24,26
2019년2분기,골목상권,창신5길,종로구,창신2동,230830,1293,22,117862,112966,159440,71392,695,598,6,16
2019년1분기,골목상권,창신길,종로구,창신2동,218679,2347,168,105205,113479,154802,63879,1180,1167,22,146
2019년2분기,골목상권,창신길,종로구,창신2동,240816,2347,173,115056,125767,164979,75841,1180,1167,28,145
2019년1분기,골목상권,신흥로20길,용산구,후암동,109687,2708,235,54788,54899,76161,33526,1319,1389,105,130
2019년2분기,골목상권,신흥로20길,용산구,후암동,141228,2708,171,69943,71284,95710,45518,1319,1389,120,51
2019년1분기,골목상권,우사단로10길,용산구,보광동,194669,2666,90,100651,94019,134142,60526,1423,1243,42,48
2019년2분기,골목상권,우사단로10길,용산구,보광동,246902,2666,533,132680,114220,168740,78164,1423,1243,489,44
2019년1분기,골목상권,우사단로14길,용산구,한남동,313337,1235,1702,174470,138870,208518,104819,631,604,879,823
2019년2분기,골목상권,우사단로14길,용산구,한남동,390022,1235,2002,217524,172498,253106,136918,631,604,973,1029
2019년1분기,골목상권,우사단로4길,용산구,보광동,221591,2302,76,130949,90642,132749,88846,1154,1148,45,31
2019년2분기,골목상권,우사단로4길,용산구,보광동,259779,2302,302,155727,104049,150455,109318,1154,1148,143,159
2019년1분기,골목상권,원효로19길,용산구,원효로2동,141034,1866,767,82572,58469,111690,29347,903,963,526,241
2019년2분기,골목상권,원효로19길,용산구,원효로2동,177641,1866,481,103964,73677,137927,39713,903,963,316,165
2019년1분기,골목상권,원효로41길,용산구,원효로2동,81365,1491,254,54816,26549,64451,16910,724,767,146,108
2019년2분기,골목상권,원효로41길,용산구,원효로2동,93954,1491,200,62729,31224,73179,20773,724,767,123,77
2019년1분기,골목상권,원효로53길,용산구,용문동,307852,2331,570,193101,114752,237572,70281,1166,1165,345,225
2019년2분기,골목상권,원효로53길,용산구,용문동,275185,2331,408,164907,110280,209433,65756,1166,1165,260,148
2019년1분기,골목상권,퇴계로12길,중구,회현동,81241,935,449,41501,39739,64452,16787,457,478,244,205
2019년2분기,골목상권,퇴계로12길,중구,회현동,101546,935,278,50713,50833,80490,21056,457,478,147,131
2019년1분기,골목상권,퇴계로18길,중구,명동,44565,706,1208,19543,25022,34757,9810,350,356,374,834
2019년2분기,골목상권,퇴계로18길,중구,명동,66607,706,919,26148,40459,52416,14193,350,356,556,363
2019년1분기,골목상권,퇴계로46길,중구,장충동,210979,618,1982,116580,94399,171059,39919,322,296,875,1107
2019년2분기,골목상권,퇴계로46길,중구,장충동,260487,618,1150,145389,115098,212199,48287,322,296,556,594
2019년1분기,골목상권,퇴계로56길,중구,장충동,211366,1130,1332,107162,104200,173649,37715,580,550,829,503
2019년2분기,골목상권,퇴계로56길,중구,장충동,246419,1130,877,124551,121867,200353,46071,580,550,655,222
2019년1분기,골목상권,퇴계로8길,중구,회현동,148057,1491,856,74349,73708,112718,35339,762,729,360,496
2019년2분기,골목상권,퇴계로8길,중구,회현동,193313,1491,418,92837,100475,147171,46139,762,729,196,222
2019년1분기,골목상권,퇴계로90길,중구,신당5동,217309,3440,860,112698,104610,158520,58783,1717,1723,302,558
2019년2분기,골목상권,퇴계로90길,중구,신당5동,260903,3440,569,133106,127797,189082,71821,1717,1723,244,325
2019년1분기,골목상권,녹사평대로11길,용산구,서빙고동,7490,418,460,4216,3273,5844,1646,204,214,329,131
2019년2분기,골목상권,녹사평대로11길,용산구,서빙고동,10589,418,123,5879,4710,8140,2449,204,214,92,31
2019년1분기,골목상권,녹사평대로26길,용산구,이태원1동,123293,955,379,61925,61369,75840,47454,449,506,226,153
2019년2분기,골목상권,녹사평대로26길,용산구,이태원1동,155775,955,466,78347,77428,95722,60052,449,506,244,222
2019년1분기,골목상권,녹사평대로32길,용산구,이태원1동,168222,534,147,83237,84986,99976,68246,272,262,80,67
2019년2분기,골목상권,녹사평대로32길,용산구,이태원1동,209105,534,66,103389,105719,122288,86818,272,262,39,27
2019년1분기,골목상권,녹사평대로40나길,용산구,이태원2동,106154,771,402,52181,53974,65069,41080,358,413,233,169
2019년2분기,골목상권,녹사평대로40나길,용산구,이태원2동,186507,771,67,88290,98217,116555,69954,358,413,31,36
2019년1분기,골목상권,녹사평대로46길,용산구,이태원2동,95361,850,355,47458,47905,66569,28797,432,418,176,179
2019년2분기,골목상권,녹사평대로46길,용산구,이태원2동,122873,850,53,60668,62205,83975,38896,432,418,17,36
2019년1분기,골목상권,대사관로34길,용산구,한남동,112758,1423,620,56336,56422,82571,30187,684,739,434,186
2019년2분기,골목상권,대사관로34길,용산구,한남동,143496,1423,648,71453,72044,104591,38907,684,739,430,218
2019년1분기,골목상권,두텁바위로1길,용산구,남영동,85692,3185,1204,48139,37551,64704,20986,1705,1480,767,437
2019년2분기,골목상권,두텁바위로1길,용산구,남영동,106724,3185,616,57735,48993,80635,26093,1705,1480,340,276
2019년1분기,골목상권,백범로79길,용산구,효창동,292720,4401,869,146488,146231,222142,70583,2058,2343,527,342
2019년2분기,골목상권,백범로79길,용산구,효창동,364540,4401,945,169013,195523,269037,95504,2058,2343,583,362
2019년1분기,골목상권,백범로90길,용산구,원효로1동,243534,4152,2534,117066,126467,176867,66666,1979,2173,1735,799
2019년2분기,골목상권,백범로90길,용산구,원효로1동,338220,4152,533,159662,178558,244133,94085,1979,2173,292,241
2019년1분기,골목상권,서빙고로71길,용산구,서빙고동,67402,2522,449,39577,27827,48884,18523,1200,1322,260,189
2019년2분기,골목상권,서빙고로71길,용산구,서빙고동,85147,2522,423,46898,38247,59908,25233,1200,1322,264,159
2019년1분기,골목상권,소월로20길,용산구,용산2가동,177764,2227,95,86417,91345,123853,53915,1069,1158,48,47
2019년2분기,골목상권,소월로20길,용산구,용산2가동,227202,2227,106,107643,119558,156367,70831,1069,1158,39,67
2019년1분기,골목상권,청파로71길,용산구,청파동,337509,4221,1249,167852,169657,245166,92345,2138,2083,731,518
2019년2분기,골목상권,청파로71길,용산구,청파동,416518,4221,781,206554,209970,301809,114709,2138,2083,568,213
2019년1분기,골목상권,청파로73길,용산구,청파동,149397,2495,285,84598,64798,111927,37475,1272,1223,146,139
2019년2분기,골목상권,청파로73길,용산구,청파동,191107,2495,236,106264,84843,142669,48435,1272,1223,126,110
2019년1분기,골목상권,한강대로104길,용산구,남영동,189399,2701,10510,105954,83444,147922,41474,1474,1227,2770,7740
2019년2분기,골목상권,한강대로104길,용산구,남영동,230889,2701,8558,129401,101491,178308,52588,1474,1227,1934,6624
2019년1분기,골목상권,고산자로6길,성동구,행당1동,497903,4112,721,252443,245460,351011,146890,1971,2141,332,389
2019년2분기,골목상권,고산자로6길,성동구,행당1동,599127,4112,7561,301800,297333,417409,181715,1971,2141,2336,5225
2019년1분기,골목상권,금호산2길,성동구,금호2.3가동,102384,2321,26,51179,51204,71522,30862,1168,1153,15,11
2019년2분기,골목상권,금호산2길,성동구,금호2.3가동,111889,2321,89,53077,58811,75314,36574,1168,1153,66,23
2019년1분기,골목상권,금호산길,성동구,금호2.3가동,303054,3321,304,146016,157041,216598,86467,1647,1674,114,190
2019년2분기,골목상권,금호산길,성동구,금호2.3가동,342698,3321,167,159637,183061,242080,100620,1647,1674,88,79
2019년1분기,골목상권,둘레9길,성동구,성수1가1동,121883,2877,534,69146,52739,86606,35275,1548,1329,341,193
2019년2분기,골목상권,둘레9길,성동구,성수1가1동,147254,2877,450,82472,64783,102745,44514,1548,1329,282,168
2019년1분기,골목상권,뚝섬로5길,성동구,성수2가1동,88574,1831,3928,48403,40168,70763,17815,889,942,2375,1553
2019년2분기,골목상권,뚝섬로5길,성동구,성수2가1동,109642,1831,1930,58628,51017,84980,24665,889,942,1347,583
2019년1분기,골목상권,마장로27길,성동구,마장동,74874,1827,408,38002,36872,56093,18781,916,911,235,173
2019년2분기,골목상권,마장로27길,성동구,마장동,133881,1827,213,65726,68158,95079,38807,916,911,109,104
2019년1분기,골목상권,마장로39길,성동구,마장동,128693,1329,718,67884,60810,91676,37012,653,676,484,234
2019년2분기,골목상권,마장로39길,성동구,마장동,165307,1329,477,85467,79839,115280,50030,653,676,278,199
2019년1분기,골목상권,한강대로15길,용산구,한강로동,44665,474,913,29593,15070,31658,13005,253,221,454,459
2019년2분기,골목상권,한강대로15길,용산구,한강로동,51643,474,720,33199,18446,36383,15259,253,221,400,320
2019년1분기,골목상권,한강대로43길,용산구,한강로동,311751,1590,2117,176769,134979,251091,60658,753,837,1200,917
2019년2분기,골목상권,한강대로43길,용산구,한강로동,359479,1590,1702,198409,161071,289339,70140,753,837,976,726
2019년1분기,골목상권,한강대로52길,용산구,한강로동,280052,666,3331,159381,120675,224052,56001,337,329,2305,1026
2019년2분기,골목상권,한강대로52길,용산구,한강로동,293801,666,8103,162560,131242,221898,71901,337,329,2393,5710
2019년1분기,골목상권,한강대로62길,용산구,한강로동,109141,901,1132,66443,42696,84290,24852,457,444,513,619
2019년2분기,골목상권,한강대로62길,용산구,한강로동,134732,901,658,79430,55300,101764,32970,457,444,436,222
2019년1분기,골목상권,한강대로7길,용산구,한강로동,91528,751,1792,51533,39996,64122,27405,407,344,629,1163
2019년2분기,골목상권,한강대로7길,용산구,한강로동,98628,751,500,55139,43488,68501,30128,407,344,370,130
2019년1분기,골목상권,한강대로88길,용산구,남영동,42666,109,333,23881,18784,33163,9503,84,25,228,105
2019년2분기,골목상권,한강대로88길,용산구,남영동,51481,109,173,27886,23595,40138,11343,84,25,131,42
2019년1분기,골목상권,한남대로20길,용산구,한남동,193378,566,1036,86646,106732,144779,48596,257,309,528,508
2019년2분기,골목상권,한남대로20길,용산구,한남동,235787,566,460,104801,130988,175800,59984,257,309,247,213
2019년1분기,골목상권,회나무로13길,용산구,이태원2동,127963,2228,237,60744,67220,86901,41061,987,1241,107,130
2019년2분기,골목상권,회나무로13길,용산구,이태원2동,164640,2228,1739,77723,86916,109647,54993,987,1241,704,1035
2019년1분기,골목상권,효창원로39길,용산구,용문동,217939,3151,236,107926,110016,151538,66398,1495,1656,97,139
2019년2분기,골목상권,효창원로39길,용산구,용문동,258257,3151,181,124478,133779,178629,79630,1495,1656,104,77
2019년1분기,골목상권,후암로28길,용산구,후암동,226783,5621,1018,118503,108283,160329,66460,2687,2934,511,507
2019년2분기,골목상권,후암로28길,용산구,후암동,268681,5621,600,140383,128296,185959,82728,2687,2934,312,288
2019년1분기,골목상권,원효로89길,용산구,원효로1동,360376,1019,1336,201932,158443,283139,77241,493,526,937,399
2019년2분기,골목상권,원효로89길,용산구,원효로1동,455444,1019,1495,254871,200570,359115,96325,493,526,1046,449
2019년1분기,골목상권,이촌로22길,용산구,이촌2동,50169,1812,231,28397,21769,36763,13406,866,946,132,99
2019년2분기,골목상권,이촌로22길,용산구,이촌2동,59294,1812,376,34191,25105,42005,17292,866,946,305,71
2019년1분기,골목상권,이태원로27길,용산구,이태원1동,216048,636,960,111393,104659,115645,100399,314,322,559,401
2019년2분기,골목상권,이태원로27길,용산구,이태원1동,319314,636,1061,160884,158433,174297,145016,314,322,681,380
2019년1분기,골목상권,이태원로54길,용산구,한남동,257689,2351,1630,122423,135266,182723,74969,1033,1318,916,714
2019년2분기,골목상권,이태원로54길,용산구,한남동,293194,2351,889,135807,157386,207945,85255,1033,1318,578,311
2019년1분기,골목상권,장문로45길,용산구,보광동,141977,2928,207,75855,66124,101738,40243,1394,1534,103,104
2019년2분기,골목상권,장문로45길,용산구,보광동,169792,2928,141,89039,80755,120239,49555,1394,1534,75,66
2019년1분기,골목상권,청파로47길,용산구,청파동,941621,1678,642,316460,625160,704100,237525,654,1024,300,342
2019년2분기,골목상권,청파로47길,용산구,청파동,1248358,1678,257,356032,892325,952851,295507,654,1024,126,131
2019년1분기,골목상권,청파로47나길,용산구,청파동,134996,3109,226,54344,80651,93709,41278,1469,1640,144,82
2019년2분기,골목상권,청파로47나길,용산구,청파동,147086,3109,242,57255,89833,101977,45099,1469,1640,147,95
2019년1분기,골목상권,성수일로6길,성동구,성수2가3동,246209,624,3304,147134,99075,202866,43346,355,269,1855,1449
2019년2분기,골목상권,성수일로6길,성동구,성수2가3동,306638,624,1732,177485,129152,253730,52910,355,269,1101,631
2019년1분기,골목상권,송정12라길,성동구,송정동,120559,1292,180,63328,57230,84247,36306,693,599,103,77
2019년2분기,골목상권,송정12라길,성동구,송정동,147373,1292,127,77266,70107,101513,45856,693,599,44,83
2019년1분기,골목상권,송정4가길,성동구,송정동,288012,2678,399,166544,121468,214949,73062,1440,1238,168,231
2019년2분기,골목상권,송정4가길,성동구,송정동,368262,2678,443,210786,157475,275822,92442,1440,1238,269,174
2019년1분기,골목상권,아차산로11길,성동구,성수2가3동,183181,355,5637,105182,77998,154426,28755,206,149,3538,2099
2019년2분기,골목상권,아차산로11길,성동구,성수2가3동,205355,355,3847,116182,89172,172661,32698,206,149,2751,1096
2019년1분기,골목상권,아차산로15길,성동구,성수2가3동,139274,429,8949,85859,53412,119800,19472,249,180,5387,3562
2019년2분기,골목상권,아차산로15길,성동구,성수2가3동,175868,429,3698,105442,70427,151864,24003,249,180,2616,1082
2019년1분기,골목상권,아차산로5길,성동구,성수2가3동,76606,1820,4273,47154,29453,63418,13189,953,867,2624,1649
2019년2분기,골목상권,아차산로5길,성동구,성수2가3동,97705,1820,1961,57894,39809,80377,17328,953,867,1073,888
2019년1분기,골목상권,왕십리로14길,성동구,성수1가2동,161737,1831,4319,93267,68472,125469,36274,945,886,2342,1977
2019년2분기,골목상권,왕십리로14길,성동구,성수1가2동,175401,1831,1050,95819,79582,133490,41909,945,886,758,292
2019년1분기,골목상권,마조로16길,성동구,마장동,154871,2709,307,86057,68813,113234,41637,1352,1357,203,104
2019년2분기,골목상권,마조로16길,성동구,마장동,190900,2709,168,101798,89102,137692,53211,1352,1357,103,65
2019년1분기,골목상권,마조로1길,성동구,사근동,482923,1219,107,227791,255131,334919,148005,570,649,57,50
2019년2분기,골목상권,마조로1길,성동구,사근동,570232,1219,79,273280,296951,395327,174905,570,649,53,26
2019년1분기,골목상권,매봉길,성동구,옥수동,71933,5859,177,33405,38529,49697,22238,2768,3091,72,105
2019년2분기,골목상권,매봉길,성동구,옥수동,88218,5859,67,41352,46866,60138,28082,2768,3091,39,28
2019년1분기,골목상권,무수막길,성동구,금호2.3가동,366610,2199,209,177754,188856,260114,106493,1053,1146,96,113
2019년2분기,골목상권,무수막길,성동구,금호2.3가동,427732,2199,200,204039,223692,299259,128472,1053,1146,148,52
2019년1분기,골목상권,무학로6길,성동구,왕십리도선동,448115,1814,725,231817,216297,326102,122019,892,922,346,379
2019년2분기,골목상권,무학로6길,성동구,왕십리도선동,551703,1814,771,278397,273309,398120,153586,892,922,332,439
2019년1분기,골목상권,무학봉28길,성동구,왕십리2동,145159,1004,399,73187,71975,107359,37802,463,541,190,209
2019년2분기,골목상권,무학봉28길,성동구,왕십리2동,166560,1004,202,81752,84807,121277,45287,463,541,89,113
2019년1분기,골목상권,무학봉길,성동구,왕십리2동,125535,2274,147,58387,67147,87983,37552,1137,1137,61,86
2019년2분기,골목상권,무학봉길,성동구,왕십리2동,157582,2274,45,71846,85737,108100,49487,1137,1137,22,23
2019년1분기,골목상권,사근동길,성동구,사근동,248564,2405,112,124384,124181,185064,63496,1346,1059,66,46
2019년2분기,골목상권,사근동길,성동구,사근동,283685,2405,107,136551,147134,215725,67959,1346,1059,57,50
2019년1분기,골목상권,상원12길,성동구,성수1가2동,110512,2392,888,61948,48563,81518,28999,1211,1181,514,374
2019년2분기,골목상권,상원12길,성동구,성수1가2동,139566,2392,339,78080,61488,101827,37730,1211,1181,197,142
2019년1분기,골목상권,상원길,성동구,성수1가2동,286238,1128,3915,165418,120819,234676,51558,576,552,2528,1387
2019년2분기,골목상권,상원길,성동구,성수1가2동,344182,1128,2490,197056,147124,282114,62065,576,552,1650,840
2019년1분기,골목상권,서울숲2길,성동구,성수1가2동,278395,1793,748,148013,130385,202984,75409,895,898,378,370
2019년2분기,골목상권,서울숲2길,성동구,성수1가2동,519499,1793,447,244676,274824,337534,181969,895,898,274,173
2019년1분기,골목상권,성덕정17길,성동구,성수2가1동,221294,3526,637,123976,97315,158120,63180,1880,1646,404,233
2019년2분기,골목상권,성덕정17길,성동구,성수2가1동,268230,3526,452,151205,117024,189098,79129,1880,1646,287,165
2019년1분기,골목상권,성덕정길,성동구,성수1가1동,95981,3209,349,54451,41530,69928,26054,1669,1540,208,141
2019년2분기,골목상권,성덕정길,성동구,성수1가1동,127634,3209,266,71189,56443,90222,37412,1669,1540,180,86
2019년1분기,골목상권,성수이로18길,성동구,성수2가3동,138259,259,4407,83500,54758,113569,24689,150,109,2605,1802
2019년2분기,골목상권,성수이로18길,성동구,성수2가3동,184602,259,3060,108710,75892,148917,35682,150,109,2001,1059
2019년1분기,골목상권,성수이로7길,성동구,성수2가3동,277400,1289,2336,160978,116422,222572,54828,695,594,1348,988
2019년2분기,골목상권,성수이로7길,성동구,성수2가3동,362013,1289,1947,196855,165157,285594,76418,695,594,1198,749
2019년1분기,골목상권,장터길,성동구,금호2.3가동,134874,1949,240,69771,65104,95894,38980,943,1006,104,136
2019년2분기,골목상권,장터길,성동구,금호2.3가동,143244,1949,118,73856,69389,100243,43001,943,1006,56,62
2019년1분기,골목상권,청계천로10나길,성동구,마장동,143981,2624,5762,85402,58578,115425,28558,1338,1286,4131,1631
2019년2분기,골목상권,청계천로10나길,성동구,마장동,194502,2624,972,112051,82451,152729,41777,1338,1286,621,351
2019년1분기,골목상권,한림말3길,성동구,옥수동,147782,922,332,68411,79370,108234,39548,437,485,165,167
2019년2분기,골목상권,한림말3길,성동구,옥수동,179424,922,2979,80931,98493,130172,49250,437,485,1079,1900
2019년1분기,골목상권,긴고랑로8길,광진구,중곡1동,169906,4150,811,87940,81970,118253,51658,2091,2059,527,284
2019년2분기,골목상권,긴고랑로8길,광진구,중곡1동,242067,4150,954,121480,120585,166430,75639,2091,2059,608,346
2019년1분기,골목상권,긴고랑로9길,광진구,중곡3동,209314,2083,356,100449,108863,150336,58977,1048,1035,156,200
2019년2분기,골목상권,긴고랑로9길,광진구,중곡3동,270044,2083,79,127208,142838,191104,78947,1048,1035,25,54
2019년1분기,골목상권,능동로13길,광진구,화양동,456022,3647,308,222944,233079,309230,146785,1728,1919,124,184
2019년2분기,골목상권,능동로13길,광진구,화양동,549003,3647,233,266656,282347,366841,182163,1728,1919,114,119
2019년1분기,골목상권,능동로19길,광진구,화양동,359622,2317,239,186676,172947,252835,106790,1125,1192,127,112
2019년2분기,골목상권,능동로19길,광진구,화양동,413891,2317,170,213302,200589,288752,125144,1125,1192,99,71
2019년1분기,골목상권,능동로34길,광진구,능동,166395,5108,819,78431,87963,119885,46509,2347,2761,484,335
2019년2분기,골목상권,능동로34길,광진구,능동,221165,5108,1054,100845,120318,155511,65646,2347,2761,699,355
2019년1분기,골목상권,능동로3길,광진구,자양4동,269352,3639,212,138401,130951,188804,80546,1812,1827,134,78
2019년2분기,골목상권,능동로3길,광진구,자양4동,414700,3639,70,201908,212790,284075,130622,1812,1827,45,25
2019년1분기,골목상권,한림말길,성동구,옥수동,209460,2107,470,96102,113358,151064,58396,976,1131,172,298
2019년2분기,골목상권,한림말길,성동구,옥수동,235915,2107,348,107148,128767,169041,66874,976,1131,165,183
2019년1분기,골목상권,광나루로12길,광진구,화양동,292511,2765,195,153309,139203,204432,88083,1353,1412,102,93
2019년2분기,골목상권,광나루로12길,광진구,화양동,386202,2765,55,203848,182354,260523,125682,1353,1412,18,37
2019년1분기,골목상권,광나루로24길,광진구,화양동,235135,1289,215,126312,108824,171686,63454,684,605,118,97
2019년2분기,골목상권,광나루로24길,광진구,화양동,334413,1289,32,179865,154552,250794,83620,684,605,21,11
2019년1분기,골목상권,광나루로36길,광진구,구의1동,81165,2665,396,40993,40170,58172,22993,1284,1381,134,262
2019년2분기,골목상권,광나루로36길,광진구,구의1동,105121,2665,428,51657,53460,75711,29407,1284,1381,176,252
2019년1분기,골목상권,광나루로37길,광진구,구의2동,220082,679,100,109166,110914,159858,60220,329,350,38,62
2019년2분기,골목상권,광나루로37길,광진구,구의2동,282214,679,72,138734,143480,200785,81432,329,350,31,41
2019년1분기,골목상권,광나루로40길,광진구,구의1동,329525,3897,314,155739,173786,231529,97995,1941,1956,156,158
2019년2분기,골목상권,광나루로40길,광진구,구의1동,404053,3897,305,187328,216727,279889,124166,1941,1956,185,120
2019년1분기,골목상권,광나루로52길,광진구,구의3동,270461,4356,398,134408,136051,191368,79093,2072,2284,198,200
2019년2분기,골목상권,광나루로52길,광진구,구의3동,326733,4356,656,158901,167832,227732,99002,2072,2284,440,216
2019년1분기,골목상권,긴고랑로20길,광진구,중곡2동,119606,4137,498,59659,59948,86301,33309,1973,2164,226,272
2019년2분기,골목상권,긴고랑로20길,광진구,중곡2동,158656,4137,242,79484,79172,113355,45297,1973,2164,121,121
2019년1분기,골목상권,긴고랑로7길,광진구,중곡1동,150870,4756,346,77510,73358,107067,43801,2316,2440,189,157
2019년2분기,골목상권,긴고랑로7길,광진구,중곡1동,191059,4756,563,97265,93791,134606,56449,2316,2440,443,120
2019년1분기,골목상권,왕십리로21길,성동구,행당1동,185559,2417,192,89494,96065,128684,56877,1131,1286,78,114
2019년2분기,골목상권,왕십리로21길,성동구,행당1동,216977,2417,132,103090,113889,148623,68360,1131,1286,62,70
2019년1분기,골목상권,왕십리로26길,성동구,왕십리도선동,484392,2882,1785,250991,233402,355540,128858,1438,1444,1188,597
2019년2분기,골목상권,왕십리로26길,성동구,왕십리도선동,555456,2882,1414,277247,278207,405485,149971,1438,1444,738,676
2019년1분기,골목상권,왕십리로31길,성동구,왕십리2동,334699,2870,343,154854,179849,241107,93596,1363,1507,147,196
2019년2분기,골목상권,왕십리로31길,성동구,왕십리2동,405400,2870,243,181875,223522,286495,118906,1363,1507,104,139
2019년1분기,골목상권,왕십리로6길,성동구,성수1가2동,376274,2259,5545,209929,166349,306866,69413,1143,1116,3231,2314
2019년2분기,골목상권,왕십리로6길,성동구,성수1가2동,557857,2259,753,296382,261478,435871,121993,1143,1116,483,270
2019년1분기,골목상권,용답29길,성동구,용답동,197624,3063,1334,108565,89054,141540,56087,1536,1527,779,555
2019년2분기,골목상권,용답29길,성동구,용답동,223275,3063,548,117955,105316,158999,64275,1536,1527,346,202
2019년1분기,골목상권,용답중앙길,성동구,용답동,98765,2613,361,50082,48685,69791,28976,1350,1263,244,117
2019년2분기,골목상권,용답중앙길,성동구,용답동,114874,2613,344,57134,57742,79686,35186,1350,1263,121,223
2019년1분기,골목상권,용마산로3길,광진구,중곡2동,184653,3903,604,88485,96167,133654,51009,1902,2001,317,287
2019년2분기,골목상권,용마산로3길,광진구,중곡2동,232313,3903,564,110649,121664,165788,66523,1902,2001,432,132
2019년1분기,골목상권,자양로11길,광진구,자양1동,608094,3832,880,310647,297448,439479,168618,1873,1959,394,486
2019년2분기,골목상권,자양로11길,광진구,자양1동,702473,3832,705,347448,355026,503089,199387,1873,1959,274,431
2019년1분기,골목상권,자양로15길,광진구,자양1동,247402,1886,134,127141,120262,182902,64501,846,1040,59,75
2019년2분기,골목상권,자양로15길,광진구,자양1동,275491,1886,81,138660,136831,202596,72893,846,1040,42,39
2019년1분기,골목상권,자양로26길,광진구,구의1동,209929,3052,206,102067,107857,145356,64578,1455,1597,99,107
2019년2분기,골목상권,자양로26길,광진구,구의1동,255480,3052,173,119088,136392,176183,79302,1455,1597,97,76
2019년1분기,골목상권,자양로45길,광진구,중곡4동,366910,2530,358,174123,192783,253044,113868,1204,1326,149,209
2019년2분기,골목상권,자양로45길,광진구,중곡4동,457436,2530,449,212985,244451,313737,143696,1204,1326,177,272
2019년1분기,골목상권,자양로50길,광진구,구의2동,131732,4521,154,66265,65466,89721,42014,2199,2322,66,88
2019년2분기,골목상권,자양로50길,광진구,구의2동,186999,4521,246,89540,97459,127197,59802,2199,2322,143,103
2019년1분기,골목상권,능동로4길,광진구,자양3동,141509,3013,239,70403,71104,100433,41069,1483,1530,131,108
2019년2분기,골목상권,능동로4길,광진구,자양3동,209283,3013,963,107559,101723,155907,53374,1483,1530,843,120
2019년1분기,골목상권,동일로18길,광진구,자양4동,239840,1845,419,121137,118706,168381,71461,958,887,210,209
2019년2분기,골목상권,동일로18길,광진구,자양4동,217714,1845,116,114438,103277,151235,66482,958,887,58,58
2019년1분기,골목상권,동일로24길,광진구,화양동,374347,2973,118,199752,174593,269334,105012,1440,1533,62,56
2019년2분기,골목상권,동일로24길,광진구,화양동,423160,2973,62,223392,199766,299742,123418,1440,1533,50,12
2019년1분기,골목상권,뚝섬로23길,광진구,자양3동,218490,1914,142,109757,108730,153230,65264,941,973,64,78
2019년2분기,골목상권,뚝섬로23길,광진구,자양3동,187949,1914,219,98453,89497,128922,59032,941,973,155,64
2019년1분기,골목상권,뚝섬로24길,광진구,자양4동,67322,2990,259,38627,28698,46947,20376,1508,1482,132,127
2019년2분기,골목상권,뚝섬로24길,광진구,자양4동,96715,2990,119,49844,46878,64482,32237,1508,1482,74,45
2019년1분기,골목상권,뚝섬로48길,광진구,자양2동,233299,3659,385,120776,112521,163293,70010,1781,1878,167,218
2019년2분기,골목상권,뚝섬로48길,광진구,자양2동,287918,3659,243,143982,143936,197627,90293,1781,1878,144,99
2019년1분기,골목상권,뚝섬로54길,광진구,자양2동,58910,3665,157,27655,31255,40447,18462,1805,1860,83,74
2019년2분기,골목상권,뚝섬로54길,광진구,자양2동,85477,3665,981,43357,42123,56932,28551,1805,1860,835,146
2019년1분기,골목상권,뚝섬로58길,광진구,자양2동,154112,3603,478,76480,77632,111278,42834,1730,1873,247,231
2019년2분기,골목상권,뚝섬로58길,광진구,자양2동,186682,3603,389,92453,94228,133325,53366,1730,1873,185,204
2019년1분기,골목상권,뚝섬로64길,광진구,자양2동,181961,2935,227,97120,84843,130532,51434,1471,1464,115,112
2019년2분기,골목상권,뚝섬로64길,광진구,자양2동,208789,2935,306,104840,103951,148601,60188,1471,1464,169,137
2019년1분기,골목상권,면목로17길,광진구,중곡3동,332273,4210,399,179756,152519,231381,100892,2099,2111,277,122
2019년2분기,골목상권,면목로17길,광진구,중곡3동,394377,4210,194,209878,184498,268273,126106,2099,2111,104,90
2019년1분기,골목상권,아차산로40길,광진구,자양1동,136852,3042,404,65442,71411,94998,41857,1494,1548,216,188
2019년2분기,골목상권,아차산로40길,광진구,자양1동,172997,3042,465,85357,87638,117721,55273,1494,1548,253,212
2019년1분기,골목상권,아차산로51길,광진구,구의1동,116612,1779,349,58617,57995,81620,34991,832,947,130,219
2019년2분기,골목상권,아차산로51길,광진구,구의1동,135510,1779,475,67005,68508,95985,39525,832,947,130,345
2019년1분기,골목상권,아차산로55길,광진구,구의1동,498920,2877,281,262016,236905,327751,171175,1344,1533,163,118
2019년2분기,골목상권,아차산로55길,광진구,구의1동,605870,2877,322,317749,288122,394131,211740,1344,1533,204,118
2019년1분기,골목상권,아차산로65길,광진구,구의3동,241069,3001,534,115012,126058,169815,71258,1415,1586,277,257
2019년2분기,골목상권,아차산로65길,광진구,구의3동,274556,3001,525,130231,144327,188371,86190,1415,1586,358,167
2019년1분기,골목상권,아차산로78길,광진구,광장동,151766,1476,1380,81149,70619,110531,41235,708,768,599,781
2019년2분기,골목상권,아차산로78길,광진구,광장동,177793,1476,660,92130,85661,128321,49471,708,768,474,186
2019년1분기,골목상권,용마산로21길,광진구,중곡2동,393340,5416,577,206633,186704,277606,115733,2681,2735,313,264
2019년2분기,골목상권,용마산로21길,광진구,중곡2동,485897,5416,364,251379,234515,340306,145592,2681,2735,223,141
2019년1분기,골목상권,경희대로4길,동대문구,회기동,619956,1245,147,304641,315312,475933,144020,634,611,63,84
2019년2분기,골목상권,경희대로4길,동대문구,회기동,790799,1245,36,380967,409831,608052,182748,634,611,12,24
2019년1분기,골목상권,난계로30길,동대문구,용신동,85985,214,5461,48723,37260,61389,24596,127,87,2369,3092
2019년2분기,골목상권,난계로30길,동대문구,용신동,100969,214,5259,57392,43576,71977,28994,127,87,2277,2982
2019년1분기,골목상권,답십리로23길,동대문구,전농1동,317762,2334,89,170083,147678,223685,94075,1151,1183,59,30
2019년2분기,골목상권,답십리로23길,동대문구,전농1동,386615,2334,57,207634,178984,269726,116893,1151,1183,32,25
2019년1분기,골목상권,망우로21길,동대문구,휘경1동,157845,559,439,85203,72643,109609,48237,285,274,277,162
2019년2분기,골목상권,망우로21길,동대문구,휘경1동,198317,559,131,104663,93652,136315,62004,285,274,89,42
2019년1분기,골목상권,무학로16길,동대문구,용신동,45520,1368,1182,27777,17745,37460,8065,702,666,607,575
2019년2분기,골목상권,무학로16길,동대문구,용신동,51083,1368,700,32857,18227,41203,9877,702,666,430,270
2019년1분기,골목상권,무학로45길,동대문구,용신동,370225,1054,314,228422,141802,285284,84938,620,434,191,123
2019년2분기,골목상권,무학로45길,동대문구,용신동,460911,1054,296,281932,178981,356986,103928,620,434,172,124
2019년1분기,골목상권,사가정로13길,동대문구,전농2동,128773,2001,250,62530,66245,98001,30773,978,1023,101,149
2019년2분기,골목상권,사가정로13길,동대문구,전농2동,93021,2001,206,43965,49057,70739,22286,978,1023,72,134
2019년1분기,골목상권,사가정로23가길,동대문구,장안2동,126026,2021,246,65031,60996,89003,37022,977,1044,127,119
2019년2분기,골목상권,사가정로23가길,동대문구,장안2동,145020,2021,109,73271,71750,99898,45118,977,1044,47,62
2019년1분기,골목상권,사가정로2길,동대문구,답십리1동,122326,1821,167,60824,61502,89519,32815,891,930,118,49
2019년2분기,골목상권,사가정로2길,동대문구,답십리1동,146401,1821,283,72966,73430,106038,40357,891,930,192,91
2019년1분기,골목상권,서울시립대로16길,동대문구,전농1동,241280,3392,166,119254,122023,175145,66138,1662,1730,57,109
2019년2분기,골목상권,서울시립대로16길,동대문구,전농1동,255695,3392,20,126615,129079,183440,72259,1662,1730,9,11
2019년1분기,골목상권,답십리로56길,동대문구,답십리2동,211614,3636,198,106407,105206,146809,64801,1799,1837,94,104
2019년2분기,골목상권,답십리로56길,동대문구,답십리2동,253536,3636,90,128068,125466,170947,82598,1799,1837,47,43
2019년1분기,골목상권,답십리로60길,동대문구,답십리2동,44825,1715,536,23093,21731,31892,12934,880,835,312,224
2019년2분기,골목상권,답십리로60길,동대문구,답십리2동,51785,1715,354,26464,25322,36188,15595,880,835,216,138
2019년1분기,골목상권,답십리로63길,동대문구,장안2동,65079,1374,95,33438,31643,45576,19501,706,668,40,55
2019년2분기,골목상권,답십리로63길,동대문구,장안2동,75599,1374,1756,38704,36895,52242,23354,706,668,1034,722
2019년1분기,골목상권,답십리로64길,동대문구,장안1동,189683,2831,347,101103,88576,133513,56177,1412,1419,219,128
2019년2분기,골목상권,답십리로64길,동대문구,장안1동,225904,2831,137,121281,104623,156742,69166,1412,1419,88,49
2019년1분기,골목상권,답십리로68길,동대문구,장안1동,265163,3318,696,142808,122355,183979,81179,1714,1604,382,314
2019년2분기,골목상권,답십리로68길,동대문구,장안1동,319289,3318,429,170435,148855,220058,99234,1714,1604,199,230
2019년1분기,골목상권,답십리로69길,동대문구,장안2동,142421,1795,930,80696,61726,105671,36748,946,849,429,501
2019년2분기,골목상권,답십리로69길,동대문구,장안2동,170357,1795,487,94436,75923,124346,46014,946,849,280,207
2019년1분기,골목상권,답십리로72길,동대문구,장안1동,143416,1142,242,78793,64622,100553,42865,558,584,125,117
2019년2분기,골목상권,답십리로72길,동대문구,장안1동,172567,1142,95,94169,78398,118970,53596,558,584,36,59
2019년1분기,골목상권,망우로18가길,동대문구,휘경2동,132987,2586,23,71707,61281,93607,39384,1346,1240,13,10
2019년2분기,골목상권,망우로18가길,동대문구,휘경2동,148590,2586,101,77619,70967,103476,45115,1346,1240,72,29
2019년1분기,골목상권,망우로18길,동대문구,휘경2동,338020,1556,440,185466,152553,236831,101182,765,791,170,270
2019년2분기,골목상권,망우로18길,동대문구,휘경2동,411087,1556,232,218007,193083,283692,127399,765,791,79,153
2019년1분기,골목상권,자양로53길,광진구,중곡4동,181371,2772,250,86922,94451,124681,56691,1340,1432,133,117
2019년2분기,골목상권,자양로53길,광진구,중곡4동,213083,2772,222,102290,110793,144391,68693,1340,1432,137,85
2019년1분기,골목상권,자양번영로3길,광진구,자양3동,225367,3711,244,113643,111729,158955,66409,1870,1841,138,106
2019년2분기,골목상권,자양번영로3길,광진구,자양3동,299115,3711,254,145798,153314,203759,95354,1870,1841,148,106
2019년1분기,골목상권,천호대로109길,광진구,중곡2동,857338,3559,975,448775,408566,621581,235755,1663,1896,526,449
2019년2분기,골목상권,천호대로109길,광진구,중곡2동,1023287,3559,1000,524264,499022,739362,283922,1663,1896,525,475
2019년1분기,골목상권,천호대로123길,광진구,중곡2동,102628,3065,1171,49835,52792,72060,30570,1474,1591,536,635
2019년2분기,골목상권,천호대로123길,광진구,중곡2동,135754,3065,566,64697,71051,94563,41184,1474,1591,273,293
2019년1분기,골목상권,천호대로129길,광진구,구의2동,232002,3330,293,120268,111734,158034,73972,1600,1730,114,179
2019년2분기,골목상권,천호대로129길,광진구,구의2동,299931,3330,376,147847,152084,200994,98935,1600,1730,233,143
2019년1분기,골목상권,경희대로3길,동대문구,회기동,125913,601,105,61262,64650,94974,30936,283,318,54,51
2019년2분기,골목상권,경희대로3길,동대문구,회기동,138979,601,20,65496,73483,104643,34334,283,318,9,11
2019년1분기,골목상권,전농로3길,동대문구,답십리1동,200856,1649,201,100563,100293,142200,58652,830,819,108,93
2019년2분기,골목상권,전농로3길,동대문구,답십리1동,240814,1649,184,115673,125142,169087,71726,830,819,131,53
2019년1분기,골목상권,전농로4길,동대문구,답십리2동,113384,1473,495,61370,52017,82762,30623,768,705,372,123
2019년2분기,골목상권,전농로4길,동대문구,답십리2동,129801,1473,356,71800,58000,92383,37417,768,705,277,79
2019년1분기,골목상권,제기로21길,동대문구,청량리동,166288,3144,99,89139,77148,115872,50415,1599,1545,45,54
2019년2분기,골목상권,제기로21길,동대문구,청량리동,200724,3144,93,104690,96032,137982,62749,1599,1545,53,40
2019년1분기,골목상권,제기로5길,동대문구,제기동,279452,1016,260,153808,125644,227496,51962,559,457,125,135
2019년2분기,골목상권,제기로5길,동대문구,제기동,493561,1016,63,262435,231124,389827,103734,559,457,51,12
2019년1분기,골목상권,천장산로7길,동대문구,이문1동,315073,1387,99,156196,158877,243196,71879,700,687,49,50
2019년2분기,골목상권,천장산로7길,동대문구,이문1동,435649,1387,82,207041,228608,355505,80143,700,687,34,48
2019년1분기,골목상권,천호대로12길,동대문구,용신동,53533,207,322,30945,22589,40826,12708,117,90,165,157
2019년2분기,골목상권,천호대로12길,동대문구,용신동,60226,207,96,34790,25437,45676,14547,117,90,53,43
2019년1분기,골목상권,서울시립대로29길,동대문구,전농1동,562096,4149,180,303471,258626,405556,156546,2109,2040,102,78
2019년2분기,골목상권,서울시립대로29길,동대문구,전농1동,681979,4149,431,376258,305724,500053,181932,2109,2040,311,120
2019년1분기,골목상권,서울시립대로4길,동대문구,전농1동,228453,2393,358,113064,115388,157280,71172,1211,1182,200,158
2019년2분기,골목상권,서울시립대로4길,동대문구,전농1동,272898,2393,380,129672,143227,183591,89310,1211,1182,244,136
2019년1분기,골목상권,약령시로17길,동대문구,제기동,139976,1564,254,83096,56880,98229,41746,820,744,126,128
2019년2분기,골목상권,약령시로17길,동대문구,제기동,190969,1564,106,109993,80973,134846,56126,820,744,73,33
2019년1분기,골목상권,왕산로32길,동대문구,용신동,65635,1076,114,38452,27186,48723,16910,566,510,59,55
2019년2분기,골목상권,왕산로32길,동대문구,용신동,75691,1076,51,40318,35374,55026,20665,566,510,28,23
2019년1분기,골목상권,왕산로33길,동대문구,제기동,273953,627,168,149916,124033,191680,82275,313,314,114,54
2019년2분기,골목상권,왕산로33길,동대문구,제기동,354431,627,78,203946,150486,250725,103702,313,314,33,45
2019년1분기,골목상권,왕산로43길,동대문구,청량리동,426417,3473,843,208515,217903,305068,121345,1786,1687,341,502
2019년2분기,골목상권,왕산로43길,동대문구,청량리동,584986,3473,581,290729,294255,413468,171518,1786,1687,225,356
2019년1분기,골목상권,이문로42길,동대문구,이문2동,297485,3339,73,155213,142277,206761,90731,1700,1639,35,38
2019년2분기,골목상권,이문로42길,동대문구,이문2동,224821,3339,62,114157,110666,154509,70312,1700,1639,39,23
2019년1분기,골목상권,장한로14길,동대문구,장안1동,45486,1457,430,24458,21032,34007,11483,746,711,230,200
2019년2분기,골목상권,장한로14길,동대문구,장안1동,64294,1457,204,33988,30306,46944,17347,746,711,127,77
2019년1분기,골목상권,장한로25길,동대문구,장안1동,148858,602,585,79441,69420,105875,42983,307,295,227,358
2019년2분기,골목상권,장한로25길,동대문구,장안1동,175705,602,314,92317,83387,123706,51999,307,295,217,97
2019년1분기,골목상권,장한로26가길,동대문구,장안2동,116272,1417,285,64727,51544,81866,34407,703,714,160,125
2019년2분기,골목상권,장한로26가길,동대문구,장안2동,132917,1417,290,73435,59483,92760,40153,703,714,169,121
2019년1분기,골목상권,장한로26길,동대문구,장안1동,320028,2624,424,162251,157775,219421,100599,1290,1334,140,284
2019년2분기,골목상권,장한로26길,동대문구,장안1동,387082,2624,2391,195878,191202,260643,126442,1290,1334,1660,731
2019년1분기,골목상권,장한로27가길,동대문구,장안2동,80830,974,342,42823,38008,57457,23376,476,498,147,195
2019년2분기,골목상권,장한로27가길,동대문구,장안2동,92433,974,190,48444,43991,64797,27633,476,498,93,97
2019년1분기,골목상권,장한로27길,동대문구,장안2동,231541,932,272,120944,110597,165713,65828,501,431,115,157
2019년2분기,골목상권,장한로27길,동대문구,장안2동,275306,932,221,140775,134528,194474,80830,501,431,120,101
2019년1분기,골목상권,장한로5길,동대문구,장안1동,274754,2085,850,155793,118959,201735,73017,1041,1044,456,394
2019년2분기,골목상권,장한로5길,동대문구,장안1동,308181,2085,419,170731,137450,226848,81331,1041,1044,227,192
2019년1분기,골목상권,장한로8길,동대문구,장안1동,158110,2291,548,91124,66987,112022,46089,1145,1146,335,213
2019년2분기,골목상권,장한로8길,동대문구,장안1동,196670,2291,394,112399,84274,139747,56925,1145,1146,240,154
2019년1분기,골목상권,전농로29길,동대문구,전농1동,335013,1970,199,165872,169137,258612,76398,978,992,115,84
2019년2분기,골목상권,전농로29길,동대문구,전농1동,399244,1970,557,199885,199365,308108,91145,978,992,400,157
2019년1분기,골목상권,한천로40길,동대문구,장안2동,99906,1844,165,49557,50350,71785,28120,926,918,97,68
2019년2분기,골목상권,한천로40길,동대문구,장안2동,109352,1844,101,53487,55867,77401,31958,926,918,66,35
2019년1분기,골목상권,한천로46길,동대문구,장안2동,79125,2386,116,39674,39448,54712,24410,1150,1236,63,53
2019년2분기,골목상권,한천로46길,동대문구,장안2동,93519,2386,240,47003,46517,63132,30388,1150,1236,97,143
2019년1분기,골목상권,휘경로14길,동대문구,휘경1동,82907,1974,96,43978,38931,57614,25291,1025,949,28,68
2019년2분기,골목상권,휘경로14길,동대문구,휘경1동,104916,1974,119,53941,50976,71671,33249,1025,949,47,72
2019년1분기,골목상권,휘경로23길,동대문구,이문1동,167473,2534,32,87097,80378,118383,49087,1247,1287,4,28
2019년2분기,골목상권,휘경로23길,동대문구,이문1동,187211,2534,181,94495,92716,128795,58414,1247,1287,136,45
2019년1분기,골목상권,동일로101길,중랑구,면목2동,159687,3029,310,76399,83289,118814,40867,1496,1533,93,217
2019년2분기,골목상권,동일로101길,중랑구,면목2동,197955,3029,120,91115,106840,144549,53405,1496,1533,50,70
2019년1분기,골목상권,동일로112길,중랑구,상봉2동,401696,4319,454,210192,191504,287484,114219,2131,2188,200,254
2019년2분기,골목상권,동일로112길,중랑구,상봉2동,514692,4319,318,263460,251233,363595,151100,2131,2188,172,146
2019년1분기,골목상권,동일로123길,중랑구,중화2동,218881,2694,304,111258,107620,154919,63963,1353,1341,149,155
2019년2분기,골목상권,동일로123길,중랑구,중화2동,274651,2694,153,140209,134443,192478,82175,1353,1341,83,70
2019년1분기,골목상권,동일로130길,중랑구,중화1동,270099,3433,132,130005,140096,192162,77939,1649,1784,76,56
2019년2분기,골목상권,동일로130길,중랑구,중화1동,324270,3433,167,157567,166703,228833,95436,1649,1784,121,46
2019년1분기,골목상권,동일로139가길,중랑구,중화2동,246201,1752,1067,128466,117734,176063,70138,897,855,619,448
2019년2분기,골목상권,동일로139가길,중랑구,중화2동,301639,1752,215,155659,145979,210364,91277,897,855,99,116
2019년1분기,골목상권,동일로139길,중랑구,중화2동,108303,2839,133,59937,48366,74340,33965,1444,1395,77,56
2019년2분기,골목상권,동일로139길,중랑구,중화2동,135026,2839,92,74344,60681,90495,44537,1444,1395,61,31
2019년1분기,골목상권,휘경로2길,동대문구,이문1동,423968,1304,240,221242,202728,321932,102034,673,631,112,128
2019년2분기,골목상권,휘경로2길,동대문구,이문1동,570555,1304,95,285464,285091,442533,128025,673,631,47,48
2019년1분기,골목상권,휘경로3길,동대문구,이문1동,552947,2597,228,279923,273024,422474,130465,1285,1312,106,122
2019년2분기,골목상권,휘경로3길,동대문구,이문1동,725111,2597,135,355792,369317,568331,156782,1285,1312,64,71
2019년1분기,골목상권,겸재로29길,중랑구,면목본동,333641,2290,236,169678,163961,241592,92052,1175,1115,97,139
2019년2분기,골목상권,겸재로29길,중랑구,면목본동,390272,2290,160,192660,197614,280008,110266,1175,1115,91,69
2019년1분기,골목상권,겸재로36길,중랑구,면목본동,226509,4285,225,122416,104094,161459,65049,2092,2193,74,151
2019년2분기,골목상권,겸재로36길,중랑구,면목본동,259283,4285,171,136884,122399,183408,75870,2092,2193,72,99
2019년1분기,골목상권,겸재로54길,중랑구,면목본동,174481,5220,169,87581,86905,119849,54637,2623,2597,60,109
2019년2분기,골목상권,겸재로54길,중랑구,면목본동,211053,5220,113,103108,107941,142526,68521,2623,2597,67,46
2019년1분기,골목상권,공릉로12가길,중랑구,묵1동,94238,1419,98,53767,40473,67992,26244,708,711,62,36
2019년2분기,골목상권,공릉로12가길,중랑구,묵1동,104354,1419,139,54034,50320,72860,31491,708,711,75,64
2019년1분기,골목상권,공릉로2길,중랑구,묵1동,289601,4220,433,138423,151176,202426,87178,2043,2177,184,249
2019년2분기,골목상권,공릉로2길,중랑구,묵1동,349868,4220,398,164060,185810,241388,108483,2043,2177,236,162
2019년1분기,골목상권,답십리로75길,중랑구,면목4동,143695,1960,93,71690,72008,100851,42840,969,991,53,40
2019년2분기,골목상권,답십리로75길,중랑구,면목4동,184591,1960,59,92617,91975,126492,58097,969,991,32,27
2019년1분기,골목상권,동일로100길,중랑구,면목2동,141965,5044,518,71577,70386,98292,43678,2557,2487,323,195
2019년2분기,골목상권,동일로100길,중랑구,면목2동,173492,5044,331,83006,90490,117171,56325,2557,2487,252,79
2019년1분기,골목상권,천호대로17길,동대문구,용신동,479093,2859,1878,249682,229406,356229,122871,1413,1446,969,909
2019년2분기,골목상권,천호대로17길,동대문구,용신동,554229,2859,2981,286810,267415,412072,142158,1413,1446,2142,839
2019년1분기,골목상권,천호대로45길,동대문구,용신동,193217,2583,56,102085,91133,140859,52362,1359,1224,20,36
2019년2분기,골목상권,천호대로45길,동대문구,용신동,202434,2583,61,106183,96246,144449,57984,1359,1224,47,14
2019년1분기,골목상권,천호대로77길,동대문구,장안1동,130884,2360,1168,71362,59518,96362,34521,1225,1135,580,588
2019년2분기,골목상권,천호대로77길,동대문구,장안1동,156164,2360,207,86628,69536,113628,42532,1225,1135,132,75
2019년1분기,골목상권,천호대로97길,동대문구,장안1동,167896,2761,752,94606,73292,123736,44162,1420,1341,536,216
2019년2분기,골목상권,천호대로97길,동대문구,장안1동,201425,2761,527,109778,91646,147636,53795,1420,1341,429,98
2019년1분기,골목상권,한천로14길,동대문구,장안1동,240958,3130,1152,129224,111734,175296,65655,1634,1496,716,436
2019년2분기,골목상권,한천로14길,동대문구,장안1동,294341,3130,781,156513,137833,212055,82286,1634,1496,497,284
2019년1분기,골목상권,한천로33길,동대문구,전농2동,106220,872,443,50446,55775,75151,31065,424,448,155,288
2019년2분기,골목상권,한천로33길,동대문구,전농2동,119805,872,208,55906,63899,82404,37404,424,448,74,134
2019년1분기,골목상권,봉화산로30길,중랑구,중화1동,180794,3219,192,91186,89609,126185,54609,1629,1590,32,160
2019년2분기,골목상권,봉화산로30길,중랑구,중화1동,209422,3219,150,105693,103726,144931,64491,1629,1590,33,117
2019년1분기,골목상권,봉화산로4길,중랑구,중화2동,153749,4652,237,80332,73415,106815,46936,2474,2178,96,141
2019년2분기,골목상권,봉화산로4길,중랑구,중화2동,187981,4652,129,98622,89356,126875,61102,2474,2178,42,87
2019년1분기,골목상권,봉화산로56길,중랑구,신내1동,385884,3893,1288,194007,191874,271112,114767,1907,1986,662,626
2019년2분기,골목상권,봉화산로56길,중랑구,신내1동,444658,3893,601,217639,227021,305783,138881,1907,1986,309,292
2019년1분기,골목상권,사가정로42길,중랑구,면목7동,127591,3131,160,67308,60283,89767,37829,1534,1597,65,95
2019년2분기,골목상권,사가정로42길,중랑구,면목7동,159771,3131,223,80479,79287,110040,49727,1534,1597,84,139
2019년1분기,골목상권,사가정로54길,중랑구,면목7동,309815,3180,323,164995,144819,217420,92396,1581,1599,116,207
2019년2분기,골목상권,사가정로54길,중랑구,면목7동,355855,3180,94,183263,172593,248588,107268,1581,1599,35,59
2019년1분기,골목상권,신내로7가길,중랑구,상봉1동,153257,3756,241,73383,79877,110033,43222,1826,1930,62,179
2019년2분기,골목상권,신내로7가길,중랑구,상봉1동,177238,3756,280,83886,93353,123493,53745,1826,1930,114,166
2019년1분기,골목상권,동일로140길,중랑구,중화1동,175909,2426,464,88239,87666,127668,48239,1269,1157,213,251
2019년2분기,골목상권,동일로140길,중랑구,중화1동,209789,2426,321,103549,106241,149576,60212,1269,1157,175,146
2019년1분기,골목상권,동일로149길,중랑구,묵2동,88331,3015,124,46011,42315,62525,25803,1486,1529,75,49
2019년2분기,골목상권,동일로149길,중랑구,묵2동,125402,3015,853,61314,64087,81688,43708,1486,1529,741,112
2019년1분기,골목상권,동일로157길,중랑구,묵2동,345348,2697,650,172413,172936,242816,102536,1341,1356,320,330
2019년2분기,골목상권,동일로157길,중랑구,묵2동,400883,2697,504,196277,204611,279119,121759,1341,1356,286,218
2019년1분기,골목상권,동일로163길,중랑구,묵2동,232539,3673,145,117696,114846,163233,69306,1839,1834,87,58
2019년2분기,골목상권,동일로163길,중랑구,묵2동,271445,3673,137,134581,136868,186924,84518,1839,1834,88,49
2019년1분기,골목상권,망우로68길,중랑구,망우본동,231347,2371,358,119957,111389,159514,71836,1219,1152,182,176
2019년2분기,골목상권,망우로68길,중랑구,망우본동,283190,2371,183,144072,139116,193445,89750,1219,1152,92,91
2019년1분기,골목상권,망우로73길,중랑구,망우본동,96383,1447,103,43931,52452,70495,25884,780,667,57,46
2019년2분기,골목상권,망우로73길,중랑구,망우본동,118682,1447,39,53321,65357,85555,33131,780,667,28,11
2019년1분기,골목상권,면목로21길,중랑구,면목4동,137489,1920,60,69086,68400,96217,41268,971,949,36,24
2019년2분기,골목상권,면목로21길,중랑구,면목4동,169392,1920,37,83808,85581,115222,54173,971,949,24,13
2019년1분기,골목상권,면목로33길,중랑구,면목4동,287651,2668,94,146427,141230,206376,81279,1356,1312,47,47
2019년2분기,골목상권,면목로33길,중랑구,면목4동,330299,2668,37,164523,165773,230793,99504,1356,1312,22,15
2019년1분기,골목상권,면목로45길,중랑구,면목3.8동,185359,1356,241,102220,83142,128907,56458,684,672,136,105
2019년2분기,골목상권,면목로45길,중랑구,면목3.8동,211997,1356,170,114261,97738,146364,65630,684,672,95,75
2019년1분기,골목상권,면목로48길,중랑구,면목3.8동,146513,3095,542,80796,65720,102443,44071,1490,1605,444,98
2019년2분기,골목상권,면목로48길,중랑구,면목3.8동,164738,3095,842,86826,77911,112828,51911,1490,1605,541,301
2019년1분기,골목상권,면목로49길,중랑구,면목3.8동,202893,2887,573,104010,98885,144783,58111,1455,1432,197,376
2019년2분기,골목상권,면목로49길,중랑구,면목3.8동,239180,2887,116,119864,119316,168318,70864,1455,1432,70,46
2019년1분기,골목상권,면목로55길,중랑구,면목본동,182844,1994,195,90626,92221,132026,50820,1014,980,89,106
2019년2분기,골목상권,면목로55길,중랑구,면목본동,223507,1994,473,107913,115592,158894,64611,1014,980,308,165
2019년1분기,골목상권,면목로56길,중랑구,면목본동,163094,2848,228,82093,81001,111084,52012,1448,1400,63,165
2019년2분기,골목상권,면목로56길,중랑구,면목본동,190239,2848,141,91193,99047,127735,62504,1448,1400,63,78
2019년1분기,골목상권,면목로78길,중랑구,면목본동,283203,5399,151,142173,141030,204245,78961,2673,2726,60,91
2019년2분기,골목상권,면목로78길,중랑구,면목본동,336391,5399,108,167527,168865,240775,95613,2673,2726,52,56
2019년1분기,골목상권,봉우재로33길,중랑구,상봉2동,213480,2159,351,118261,95219,151932,61550,1037,1122,167,184
2019년2분기,골목상권,봉우재로33길,중랑구,상봉2동,287970,2159,142,150936,137037,204280,83694,1037,1122,52,90
2019년1분기,골목상권,돌곶이로14길,성북구,석관동,115634,1295,100,58700,56932,82365,33270,651,644,41,59
2019년2분기,골목상권,돌곶이로14길,성북구,석관동,135302,1295,51,66115,69188,94614,40689,651,644,34,17
2019년1분기,골목상권,돌곶이로22길,성북구,석관동,155093,1179,84,76326,78770,111126,43968,587,592,45,39
2019년2분기,골목상권,돌곶이로22길,성북구,석관동,181499,1179,74,86632,94866,129397,52101,587,592,41,33
2019년1분기,골목상권,돌곶이로27길,성북구,장위2동,164473,2740,212,82096,82378,117247,47227,1388,1352,140,72
2019년2분기,골목상권,돌곶이로27길,성북구,장위2동,193461,2740,147,98250,95214,136206,57264,1388,1352,96,51
2019년1분기,골목상권,보문로13길,성북구,보문동,362955,2355,1136,185753,177203,260265,102692,1144,1211,731,405
2019년2분기,골목상권,보문로13길,성북구,보문동,418413,2355,1236,215833,202577,297526,120878,1144,1211,766,470
2019년1분기,골목상권,보문로26길,성북구,안암동,103095,1517,238,52714,50379,75094,27999,731,786,105,133
2019년2분기,골목상권,보문로26길,성북구,안암동,115644,1517,109,56804,58840,83795,31851,731,786,47,62
2019년1분기,골목상권,보문로31길,성북구,삼선동,248069,2921,398,120758,127314,183434,64637,1328,1593,168,230
2019년2분기,골목상권,보문로31길,성북구,삼선동,291821,2921,318,137747,154076,211640,80174,1328,1593,191,127
2019년1분기,골목상권,보문로32길,성북구,동선동,940076,1295,346,382085,557990,655922,284156,433,862,165,181
2019년2분기,골목상권,보문로32길,성북구,동선동,1120526,1295,300,437851,682676,783042,337482,433,862,142,158
2019년1분기,골목상권,삼선교로10길,성북구,삼선동,362824,2342,275,176356,186466,262299,100525,1083,1259,88,187
2019년2분기,골목상권,삼선교로10길,성북구,삼선동,465929,2342,182,224785,241143,333256,132668,1083,1259,104,78
2019년1분기,골목상권,삼선교로10다길,성북구,삼선동,162269,2290,37,85351,76923,123102,39169,1144,1146,25,12
2019년2분기,골목상권,삼선교로10다길,성북구,삼선동,200046,2290,35,103186,96864,154940,45108,1144,1146,14,21
2019년1분기,골목상권,돌곶이로28길,성북구,장위2동,93814,1015,322,47938,45874,68224,25592,553,462,148,174
2019년2분기,골목상권,돌곶이로28길,성북구,장위2동,122705,1015,247,61527,61180,89587,33117,553,462,127,120
2019년1분기,골목상권,돌곶이로41길,성북구,장위1동,120405,1915,76,63497,56910,85281,35126,957,958,44,32
2019년2분기,골목상권,돌곶이로41길,성북구,장위1동,160838,1915,55,86287,74551,110484,50349,957,958,20,35
2019년1분기,골목상권,돌곶이로8길,성북구,석관동,98582,1332,111,53216,45367,70609,27978,676,656,59,52
2019년2분기,골목상권,돌곶이로8길,성북구,석관동,132285,1332,96,68307,63980,92185,40103,676,656,61,35
2019년1분기,골목상권,동소문로13길,성북구,동선동,325119,2936,390,152096,173022,234803,90314,1331,1605,139,251
2019년2분기,골목상권,동소문로13길,성북구,동선동,377869,2936,603,176693,201174,267996,109876,1331,1605,289,314
2019년1분기,골목상권,동소문로15길,성북구,동선동,240492,1084,316,111090,129401,169184,71311,460,624,168,148
2019년2분기,골목상권,동소문로15길,성북구,동선동,281262,1084,204,128090,153171,198929,82335,460,624,142,62
2019년1분기,골목상권,동소문로26가길,성북구,동선동,327535,2278,396,127684,199853,238876,88661,897,1381,193,203
2019년2분기,골목상권,동소문로26가길,성북구,동선동,407868,2278,305,148747,259124,304030,103838,897,1381,140,165
2019년1분기,골목상권,동소문로2길,성북구,삼선동,83960,374,166,39951,44009,60444,23516,195,179,60,106
2019년2분기,골목상권,동소문로2길,성북구,삼선동,97622,374,73,45655,51968,69804,27821,195,179,25,48
2019년1분기,골목상권,동소문로6길,성북구,삼선동,77539,278,106,34966,42572,56219,21320,131,147,40,66
2019년2분기,골목상권,동소문로6길,성북구,삼선동,99106,278,46,44817,54290,71036,28069,131,147,21,25
2019년1분기,골목상권,보국문로16길,성북구,정릉4동,158831,2961,222,84588,74240,112638,46191,1468,1493,109,113
2019년2분기,골목상권,보국문로16길,성북구,정릉4동,196948,2961,228,101084,95864,137156,59794,1468,1493,128,100
2019년1분기,골목상권,용마산로100길,중랑구,망우3동,81280,3066,191,42687,38589,57331,23946,1549,1517,78,113
2019년2분기,골목상권,용마산로100길,중랑구,망우3동,90684,3066,135,47083,43603,62848,27840,1549,1517,54,81
2019년1분기,골목상권,용마산로112길,중랑구,망우본동,229008,2287,439,107235,121771,148109,80901,1161,1126,175,264
2019년2분기,골목상권,용마산로112길,중랑구,망우본동,270654,2287,115,126132,144523,172775,97883,1161,1126,62,53
2019년1분기,골목상권,용마산로118길,중랑구,망우본동,173364,1978,419,81420,91944,116693,56671,1036,942,178,241
2019년2분기,골목상권,용마산로118길,중랑구,망우본동,206638,1978,173,97102,109539,137015,69620,1036,942,107,66
2019년1분기,골목상권,용마산로94길,중랑구,면목3.8동,62090,3451,145,34456,27635,43950,18144,1778,1673,86,59
2019년2분기,골목상권,용마산로94길,중랑구,면목3.8동,91493,3451,91,50062,41435,62564,28933,1778,1673,63,28
2019년1분기,골목상권,중랑천로10길,중랑구,면목2동,220893,2611,758,113979,106915,153073,67824,1315,1296,450,308
2019년2분기,골목상권,중랑천로10길,중랑구,면목2동,273396,2611,235,139144,134250,188600,84795,1315,1296,116,119
2019년1분기,골목상권,길음로7길,성북구,길음1동,101148,275,154,48216,52932,71697,29451,139,136,50,104
2019년2분기,골목상권,길음로7길,성북구,길음1동,129012,275,15,59457,69556,90578,38432,139,136,6,9
2019년1분기,골목상권,장월로1길,성북구,월곡2동,368924,2053,184,170836,198088,266350,102569,952,1101,72,112
2019년2분기,골목상권,장월로1길,성북구,월곡2동,419332,2053,78,187575,231755,302498,116839,952,1101,16,62
2019년1분기,골목상권,장위로50길,성북구,장위3동,33448,267,299,18071,15376,24360,9091,142,125,124,175
2019년2분기,골목상권,장위로50길,성북구,장위3동,40861,267,397,23480,17380,29832,11027,142,125,188,209
2019년1분기,골목상권,정릉로26길,성북구,정릉2동,180295,1872,140,87611,92686,130234,50059,913,959,55,85
2019년2분기,골목상권,정릉로26길,성북구,정릉2동,201423,1872,277,97744,103682,141478,59947,913,959,137,140
2019년1분기,골목상권,정릉로27길,성북구,정릉2동,118293,3472,106,57686,60602,83842,34447,1704,1768,46,60
2019년2분기,골목상권,정릉로27길,성북구,정릉2동,134845,3472,114,64863,69984,93243,41608,1704,1768,51,63
2019년1분기,골목상권,정릉로8길,성북구,정릉3동,102409,1799,496,59299,43107,76445,25956,950,849,402,94
2019년2분기,골목상권,정릉로8길,성북구,정릉3동,126278,1799,1372,74330,51950,93368,32912,950,849,1139,233
2019년1분기,골목상권,종암로16길,성북구,종암동,127423,3335,138,63322,64099,92194,35232,1600,1735,67,71
2019년2분기,골목상권,종암로16길,성북구,종암동,149060,3335,175,73035,76029,106516,42547,1600,1735,69,106
2019년1분기,골목상권,종암로19길,성북구,종암동,164440,1938,260,79552,84887,114426,50008,949,989,112,148
2019년2분기,골목상권,종암로19길,성북구,종암동,186395,1938,2396,90784,95610,126913,59482,949,989,1433,963
2019년1분기,골목상권,삼선교로16가길,성북구,삼선동,551804,1760,742,257813,293986,440231,111572,890,870,432,310
2019년2분기,골목상권,삼선교로16가길,성북구,삼선동,796288,1760,110,384025,412262,638745,157542,890,870,59,51
2019년1분기,골목상권,삼양로8길,성북구,길음2동,105400,742,253,47922,57479,75452,29951,349,393,108,145
2019년2분기,골목상권,삼양로8길,성북구,길음2동,153472,742,184,67614,85860,108742,44732,349,393,88,96
2019년1분기,골목상권,성북로8길,성북구,성북동,100235,1640,554,42977,57257,73441,26791,802,838,183,371
2019년2분기,골목상권,성북로8길,성북구,성북동,119017,1640,212,53696,65318,83903,35116,802,838,119,93
2019년1분기,골목상권,솔샘로6길,성북구,정릉3동,131475,1989,56,71705,59770,92337,39134,988,1001,25,31
2019년2분기,골목상권,솔샘로6길,성북구,정릉3동,158890,1989,61,86090,72798,109775,49113,988,1001,45,16
2019년1분기,골목상권,아리랑로4길,성북구,동선동,202869,3084,797,95350,107519,140434,62435,1370,1714,360,437
2019년2분기,골목상권,아리랑로4길,성북구,동선동,242129,3084,489,111615,130514,167256,74872,1370,1714,221,268
2019년1분기,골목상권,안암로5길,성북구,안암동,101362,2233,474,58181,43184,76359,25002,1124,1109,280,194
2019년2분기,골목상권,안암로5길,성북구,안암동,129366,2233,579,73095,56270,97615,31757,1124,1109,427,152
2019년1분기,골목상권,오패산로19길,성북구,월곡1동,265621,1677,224,127126,138498,182876,82749,834,843,118,106
2019년2분기,골목상권,오패산로19길,성북구,월곡1동,338696,1677,122,157422,181273,231107,107591,834,843,52,70
2019년1분기,골목상권,오패산로3길,성북구,월곡1동,174297,3327,669,84997,89302,125217,49085,1631,1696,388,281
2019년2분기,골목상권,오패산로3길,성북구,월곡1동,224522,3327,600,104988,119531,157256,67268,1631,1696,364,236
2019년1분기,골목상권,오패산로4길,성북구,월곡2동,351494,3008,731,168846,182650,247041,104446,1454,1554,264,467
2019년2분기,골목상권,오패산로4길,성북구,월곡2동,409620,3008,662,196061,213558,287721,121900,1454,1554,406,256
2019년1분기,골목상권,인촌로17가길,성북구,안암동,236571,1621,145,113431,123144,187925,48649,824,797,77,68
2019년2분기,골목상권,인촌로17가길,성북구,안암동,304278,1621,116,145442,158837,241606,62668,824,797,70,46
2019년1분기,골목상권,인촌로1길,성북구,보문동,164323,991,355,77408,86916,119398,44932,477,514,157,198
2019년2분기,골목상권,인촌로1길,성북구,보문동,198010,991,188,87927,110082,140162,57847,477,514,88,100
2019년1분기,골목상권,개운사길,성북구,안암동,282066,1012,362,158088,123977,219607,62466,491,521,197,165
2019년2분기,골목상권,개운사길,성북구,안암동,354205,1012,190,199356,154851,278400,75808,491,521,100,90
2019년1분기,골목상권,인촌로24길,성북구,안암동,445735,701,295,288772,156963,340661,105074,410,291,141,154
2019년2분기,골목상권,인촌로24길,성북구,안암동,568391,701,1559,364118,204273,438498,129892,410,291,1001,558
2019년1분기,골목상권,인촌로5길,성북구,안암동,178651,1509,62,78591,100058,128176,50477,668,841,36,26
2019년2분기,골목상권,인촌로5길,성북구,안암동,211295,1509,72,89751,121540,151480,59816,668,841,36,36
2019년1분기,골목상권,인촌로6길,성북구,보문동,151224,987,497,79485,71739,112579,38642,496,491,248,249
2019년2분기,골목상권,인촌로6길,성북구,보문동,174778,987,222,93388,81389,128421,46361,496,491,156,66
2019년1분기,골목상권,한천로76길,성북구,석관동,289034,2191,487,150429,138604,206832,82202,1065,1126,364,123
2019년2분기,골목상권,한천로76길,성북구,석관동,292372,2191,345,146608,145762,208020,84352,1065,1126,284,61
2019년1분기,골목상권,화랑로13길,성북구,월곡2동,160138,1269,374,67991,92148,113391,46746,550,719,149,225
2019년2분기,골목상권,화랑로13길,성북구,월곡2동,193213,1269,196,75169,118041,142228,50988,550,719,85,111
2019년1분기,골목상권,화랑로14길,성북구,월곡2동,358263,1356,278,159314,198948,258703,99563,692,664,118,160
2019년2분기,골목상권,화랑로14길,성북구,월곡2동,427192,1356,141,175636,251556,309572,117618,692,664,96,45
2019년1분기,골목상권,도봉로13길,강북구,송천동,246283,1658,57,117557,128724,182239,64043,830,828,29,28
2019년2분기,골목상권,도봉로13길,강북구,송천동,303284,1658,16,141191,162093,216695,86591,830,828,14,2
2019년1분기,골목상권,도봉로18길,강북구,송중동,251589,2954,153,123662,127927,178875,72718,1458,1496,89,64
2019년2분기,골목상권,도봉로18길,강북구,송중동,316324,2954,202,150869,165458,225672,90654,1458,1496,156,46
2019년1분기,골목상권,도봉로45길,강북구,미아동,204917,3419,286,88525,116394,143607,61318,1668,1751,110,176
2019년2분기,골목상권,도봉로45길,강북구,미아동,285170,3419,109,120204,164962,197446,87721,1668,1751,55,54
2019년1분기,골목상권,도봉로67길,강북구,미아동,111223,1692,223,51974,59247,79011,32210,823,869,71,152
2019년2분기,골목상권,도봉로67길,강북구,미아동,159728,1692,124,73638,86090,112715,47013,823,869,65,59
2019년1분기,골목상권,도봉로76길,강북구,미아동,440443,3459,523,224967,215474,294555,145888,1559,1900,210,313
2019년2분기,골목상권,도봉로76길,강북구,미아동,496488,3459,325,250824,245662,328766,167723,1559,1900,151,174
2019년1분기,골목상권,도봉로8길,강북구,송중동,83480,250,27,41130,42349,56518,26959,126,124,17,10
2019년2분기,골목상권,도봉로8길,강북구,송중동,108445,250,8,52131,56315,72769,35676,126,124,6,2
2019년1분기,골목상권,화랑로19길,성북구,장위2동,169680,2315,187,87415,82263,125801,43886,1175,1140,92,95
2019년2분기,골목상권,화랑로19길,성북구,장위2동,204930,2315,57,106742,98189,146728,58197,1175,1140,25,32
2019년1분기,골목상권,화랑로1길,성북구,월곡1동,243634,2928,327,119432,124204,173941,69691,1490,1438,187,140
2019년2분기,골목상권,화랑로1길,성북구,월곡1동,297935,2928,943,144760,153176,211176,86761,1490,1438,668,275
2019년1분기,골목상권,화랑로32길,성북구,석관동,104651,3330,216,57721,46932,76239,28416,1655,1675,129,87
2019년2분기,골목상권,화랑로32길,성북구,석관동,135585,3330,359,70802,64781,97415,38171,1655,1675,266,93
2019년1분기,골목상권,화랑로40길,성북구,석관동,185682,2099,293,108557,77122,134772,50914,1076,1023,165,128
2019년2분기,골목상권,화랑로40길,성북구,석관동,213924,2099,86,122052,91872,153388,60541,1076,1023,53,33
2019년1분기,골목상권,노해로17길,강북구,수유3동,155085,2608,194,80279,74809,105360,49724,1309,1299,90,104
2019년2분기,골목상권,노해로17길,강북구,수유3동,184371,2608,103,93039,91330,124739,59637,1309,1299,50,53
2019년1분기,골목상권,노해로23길,강북구,수유2동,115814,1392,127,57730,58083,82806,33011,674,718,62,65
2019년2분기,골목상권,노해로23길,강북구,수유2동,131613,1392,87,63720,67891,92633,38981,674,718,48,39
2019년1분기,골목상권,노해로33길,강북구,수유2동,130865,2646,71,63726,67139,93770,37101,1298,1348,25,46
2019년2분기,골목상권,노해로33길,강북구,수유2동,154772,2646,104,72670,82099,109243,45530,1298,1348,40,64
2019년1분기,골목상권,덕릉로40길,강북구,번2동,84265,2213,373,39975,44288,60352,23914,1098,1115,190,183
2019년2분기,골목상권,덕릉로40길,강북구,번2동,110086,2213,159,53457,56631,76302,33785,1098,1115,89,70
2019년1분기,골목상권,덕릉로41길,강북구,번1동,208507,2702,320,104118,104390,147613,60891,1312,1390,86,234
2019년2분기,골목상권,덕릉로41길,강북구,번1동,243606,2702,171,120418,123185,170121,73481,1312,1390,89,82
2019년1분기,골목상권,종암로21길,성북구,종암동,198321,1689,380,96758,101564,142494,55832,831,858,92,288
2019년2분기,골목상권,종암로21길,성북구,종암동,238318,1689,558,112193,126125,169363,68956,831,858,351,207
2019년1분기,골목상권,종암로24가길,성북구,종암동,108565,2236,99,53312,55253,78729,29836,1105,1131,35,64
2019년2분기,골목상권,종암로24가길,성북구,종암동,124569,2236,75,61147,63423,89524,35044,1105,1131,18,57
2019년1분기,골목상권,종암로5길,성북구,종암동,161983,2400,307,81788,80195,125287,36695,1321,1079,126,181
2019년2분기,골목상권,종암로5길,성북구,종암동,231916,2400,411,118671,113247,180692,51228,1321,1079,209,202
2019년1분기,골목상권,지봉로20길,성북구,보문동,248676,2763,571,128639,120035,183492,65183,1395,1368,316,255
2019년2분기,골목상권,지봉로20길,성북구,보문동,291501,2763,3833,154054,137445,211975,79529,1395,1368,3171,662
2019년1분기,골목상권,창경궁로43길,성북구,성북동,148725,1304,442,72682,76044,105688,43039,587,717,196,246
2019년2분기,골목상권,창경궁로43길,성북구,성북동,201255,1304,576,96915,104340,141228,60026,587,717,353,223
2019년1분기,골목상권,한천로101가길,성북구,장위1동,39751,1210,83,20816,18937,28637,11115,609,601,68,15
2019년2분기,골목상권,한천로101가길,성북구,장위1동,76147,1210,8,42241,33912,54912,21245,609,601,4,4
2019년1분기,골목상권,오패산로67길,강북구,번1동,448620,2046,436,243382,205240,292366,156253,1008,1038,220,216
2019년2분기,골목상권,오패산로67길,강북구,번1동,542197,2046,307,287804,254392,349350,192850,1008,1038,111,196
2019년1분기,골목상권,인수봉로56길,강북구,인수동,52239,1885,245,23612,28625,36713,15533,899,986,209,36
2019년2분기,골목상권,인수봉로56길,강북구,인수동,67887,1885,35,31943,35945,45693,22198,899,986,22,13
2019년1분기,골목상권,인수봉로72길,강북구,인수동,169573,3721,89,81033,88538,119997,49581,1786,1935,29,60
2019년2분기,골목상권,인수봉로72길,강북구,인수동,201763,3721,67,98028,103735,141029,60735,1786,1935,25,42
2019년1분기,골목상권,인수봉로79길,강북구,인수동,83009,2696,146,38075,44934,59245,23768,1361,1335,56,90
2019년2분기,골목상권,인수봉로79길,강북구,인수동,97113,2696,226,45774,51338,68464,28649,1361,1335,155,71
2019년1분기,골목상권,한천로109길,강북구,번3동,222633,2984,798,107782,114852,159310,63324,1438,1546,416,382
2019년2분기,골목상권,한천로109길,강북구,번3동,272566,2984,549,129005,143562,189524,83043,1438,1546,347,202
2019년1분기,골목상권,한천로124나길,강북구,번1동,192064,1841,187,98361,93705,134960,57104,905,936,68,119
2019년2분기,골목상권,한천로124나길,강북구,번1동,229963,1841,36,114034,115929,158863,71101,905,936,18,18
2019년1분기,골목상권,도봉로99길,강북구,수유3동,82000,2302,122,43722,38278,58260,23741,1140,1162,71,51
2019년2분기,골목상권,도봉로99길,강북구,수유3동,107770,2302,227,53617,54154,74763,33008,1140,1162,135,92
2019년1분기,골목상권,삼각산로28길,강북구,수유3동,103176,3869,93,54223,48950,67974,35209,1859,2010,40,53
2019년2분기,골목상권,삼각산로28길,강북구,수유3동,125966,3869,98,64218,61746,83655,42316,1859,2010,43,55
2019년1분기,골목상권,삼양로20길,강북구,송천동,136503,2128,51,63790,72711,94599,41901,1084,1044,33,18
2019년2분기,골목상권,삼양로20길,강북구,송천동,164432,2128,210,77487,86945,112038,52398,1084,1044,186,24
2019년1분기,골목상권,삼양로24길,강북구,송천동,216534,3069,65,104862,111670,153614,62916,1535,1534,33,32
2019년2분기,골목상권,삼양로24길,강북구,송천동,268389,3069,32,125545,142841,188949,79435,1535,1534,19,13
2019년1분기,골목상권,삼양로27길,강북구,삼각산동,258075,1343,152,129338,128733,179664,78409,656,687,50,102
2019년2분기,골목상권,삼양로27길,강북구,삼각산동,325489,1343,12,159811,165678,223152,102335,656,687,5,7
2019년1분기,골목상권,삼양로41길,강북구,삼양동,500065,4172,291,250368,249699,349710,150356,2091,2081,170,121
2019년2분기,골목상권,삼양로41길,강북구,삼양동,591879,4172,324,288311,303567,407827,184054,2091,2081,256,68
2019년1분기,골목상권,삼양로54길,강북구,송천동,87630,3768,76,44898,42731,59962,27671,1866,1902,32,44
2019년2분기,골목상권,삼양로54길,강북구,송천동,113176,3768,317,50988,62188,77318,35865,1866,1902,73,244
2019년1분기,골목상권,삼양로77길,강북구,수유1동,107438,3122,376,53636,53806,77205,30235,1597,1525,137,239
2019년2분기,골목상권,삼양로77길,강북구,수유1동,150846,3122,158,72281,78564,104584,46269,1597,1525,67,91
2019년1분기,골목상권,삼양로93길,강북구,인수동,141174,3209,116,66124,75054,99113,42059,1594,1615,50,66
2019년2분기,골목상권,삼양로93길,강북구,인수동,160649,3209,210,73706,86944,110276,50375,1594,1615,92,118
2019년1분기,골목상권,솔매로41길,강북구,미아동,78114,3089,99,42216,35900,53554,24564,1494,1595,41,58
2019년2분기,골목상권,솔매로41길,강북구,미아동,95348,3089,91,47894,47452,63216,32137,1494,1595,53,38
2019년1분기,골목상권,솔매로45길,강북구,미아동,218417,2059,189,107910,110508,156871,61544,998,1061,85,104
2019년2분기,골목상권,솔매로45길,강북구,미아동,318760,2059,44,145566,173196,224457,94304,998,1061,15,29
2019년1분기,골목상권,솔매로50길,강북구,송중동,578144,2334,941,238377,339766,411481,166663,1086,1248,398,543
2019년2분기,골목상권,솔매로50길,강북구,송중동,777487,2334,314,324533,452953,548188,229307,1086,1248,93,221
2019년1분기,골목상권,솔샘로65길,강북구,송천동,382482,2984,318,179563,202919,277956,104520,1461,1523,124,194
2019년2분기,골목상권,솔샘로65길,강북구,송천동,461865,2984,353,211871,249996,337259,124604,1461,1523,99,254
2019년1분기,골목상권,수유로12길,강북구,수유1동,418131,3271,446,215324,202809,292645,125485,1596,1675,308,138
2019년2분기,골목상권,수유로12길,강북구,수유1동,480709,3271,190,246646,234065,332027,148684,1596,1675,119,71
2019년1분기,골목상권,오패산로30길,강북구,송중동,76332,1428,130,40207,36126,54381,21955,700,728,61,69
2019년2분기,골목상권,오패산로30길,강북구,송중동,96193,1428,41,48170,48021,68166,28026,700,728,26,15
2019년1분기,골목상권,오패산로52길,강북구,송중동,283466,2884,31,142587,140882,194914,88552,1425,1459,17,14
2019년2분기,골목상권,오패산로52길,강북구,송중동,359874,2884,120,179552,180321,241890,117986,1425,1459,53,67
2019년1분기,골목상권,덕릉로60길,도봉구,창3동,117475,2419,119,58845,58630,81674,35801,1196,1223,69,50
2019년2분기,골목상권,덕릉로60길,도봉구,창3동,123763,2419,160,59952,63811,83335,40431,1196,1223,115,45
2019년1분기,골목상권,도당로13가길,도봉구,방학2동,85238,1613,80,46340,38899,58835,26405,835,778,32,48
2019년2분기,골목상권,도당로13가길,도봉구,방학2동,101012,1613,39,53273,47740,68679,32332,835,778,23,16
2019년1분기,골목상권,도당로13바길,도봉구,방학2동,117500,3472,137,64050,53454,83274,34222,1750,1722,44,93
2019년2분기,골목상권,도당로13바길,도봉구,방학2동,138766,3472,89,72659,66110,96578,42187,1750,1722,45,44
2019년1분기,골목상권,도봉산길,도봉구,도봉1동,42449,1714,217,24094,18354,24098,18353,880,834,103,114
2019년2분기,골목상권,도봉산길,도봉구,도봉1동,62237,1714,1194,33743,28492,34483,27761,880,834,445,749
2019년1분기,골목상권,방학로10길,도봉구,방학2동,120594,1970,135,62177,58418,85484,35107,964,1006,43,92
2019년2분기,골목상권,방학로10길,도봉구,방학2동,143410,1970,79,72033,71378,100128,43281,964,1006,49,30
2019년1분기,골목상권,방학로15길,도봉구,방학3동,40152,3828,214,19412,20741,27444,12711,1896,1932,161,53
2019년2분기,골목상권,방학로15길,도봉구,방학3동,54121,3828,613,24745,29374,34902,19220,1896,1932,413,200
2019년1분기,골목상권,방학로5길,도봉구,쌍문2동,154575,3932,224,80833,73737,105641,48929,1979,1953,89,135
2019년2분기,골목상권,방학로5길,도봉구,쌍문2동,212242,3932,206,106209,106031,142522,69719,1979,1953,114,92
2019년1분기,골목상권,방학로6가길,도봉구,방학1동,198508,2117,272,106464,92044,138949,59554,1059,1058,96,176
2019년2분기,골목상권,방학로6가길,도봉구,방학1동,230290,2117,178,121395,108894,158102,72189,1059,1058,87,91
2019년1분기,골목상권,삼양로144길,도봉구,쌍문1동,70458,972,186,24669,45787,53894,16564,455,517,68,118
2019년2분기,골목상권,삼양로144길,도봉구,쌍문1동,108141,972,51,36896,71242,83776,24366,455,517,23,28
2019년1분기,골목상권,시루봉로23길,도봉구,도봉1동,82371,3560,253,45161,37214,56464,25909,1846,1714,136,117
2019년2분기,골목상권,시루봉로23길,도봉구,도봉1동,117370,3560,309,63497,53875,76022,41346,1846,1714,177,132
2019년1분기,골목상권,도당로19길,도봉구,방학1동,106829,3890,104,56183,50648,75966,30863,2034,1856,41,63
2019년2분기,골목상권,도당로19길,도봉구,방학1동,145185,3890,116,78023,67159,95994,49185,2034,1856,52,64
2019년1분기,골목상권,도당로29길,도봉구,방학1동,114165,2901,228,59103,55064,81509,32657,1461,1440,94,134
2019년2분기,골목상권,도당로29길,도봉구,방학1동,134717,2901,188,71205,63515,93170,41550,1461,1440,98,90
2019년1분기,골목상권,도봉로109길,도봉구,쌍문3동,224250,2315,269,111166,113085,162853,61398,1125,1190,178,91
2019년2분기,골목상권,도봉로109길,도봉구,쌍문3동,288644,2315,212,139702,148940,205657,82988,1125,1190,159,53
2019년1분기,골목상권,도봉로114길,도봉구,창1동,691501,4840,843,309637,381865,512762,178739,2323,2517,345,498
2019년2분기,골목상권,도봉로114길,도봉구,창1동,792428,4840,421,361858,430576,569016,223423,2323,2517,178,243
2019년1분기,골목상권,도봉로143길,도봉구,방학1동,161111,1867,282,85268,75845,111647,49462,926,941,145,137
2019년2분기,골목상권,도봉로143길,도봉구,방학1동,197292,1867,118,103520,93774,135712,61584,926,941,83,35
2019년1분기,골목상권,도봉로147길,도봉구,방학1동,269733,3517,327,141648,128089,188411,81326,1732,1785,108,219
2019년2분기,골목상권,도봉로147길,도봉구,방학1동,307036,3517,190,161783,145252,211588,95457,1732,1785,88,102
2019년1분기,골목상권,도봉로152가길,도봉구,도봉2동,47836,692,411,26344,21492,35710,12128,370,322,322,89
2019년2분기,골목상권,도봉로152가길,도봉구,도봉2동,57581,692,376,31247,26333,41911,15664,370,322,337,39
2019년1분기,골목상권,도봉로156길,도봉구,도봉2동,84920,1411,204,46030,38891,60995,23926,761,650,106,98
2019년2분기,골목상권,도봉로156길,도봉구,도봉2동,100445,1411,66,53631,46813,70784,29660,761,650,38,28
2019년1분기,골목상권,도봉로169나길,도봉구,도봉1동,42078,3054,346,24652,17425,29920,12158,1550,1504,201,145
2019년2분기,골목상권,도봉로169나길,도봉구,도봉1동,60244,3054,268,33801,26442,39625,20619,1550,1504,194,74
2019년1분기,골목상권,도봉로181길,도봉구,도봉1동,46105,1957,164,25499,20607,29840,16268,995,962,82,82
2019년2분기,골목상권,도봉로181길,도봉구,도봉1동,64093,1957,108,33759,30330,40285,23805,995,962,36,72
2019년1분기,골목상권,도봉산4길,도봉구,도봉1동,11245,373,70,6827,4419,5496,5750,197,176,42,28
2019년2분기,골목상권,도봉산4길,도봉구,도봉1동,18854,373,27,10610,8243,9438,9415,197,176,24,3
2019년1분기,골목상권,한천로130길,강북구,번1동,168356,3203,82,88224,80132,121450,46911,1627,1576,30,52
2019년2분기,골목상권,한천로130길,강북구,번1동,204279,3203,74,104232,100047,144888,59388,1627,1576,55,19
2019년1분기,골목상권,한천로132길,강북구,번1동,454782,1823,358,233282,221500,323386,131386,897,926,147,211
2019년2분기,골목상권,한천로132길,강북구,번1동,535274,1823,76,275519,259755,375132,160143,897,926,43,33
2019년1분기,골목상권,한천로139가길,강북구,수유3동,223410,1543,134,117651,105759,154366,69044,733,810,53,81
2019년2분기,골목상권,한천로139가길,강북구,수유3동,253070,1543,112,131161,121911,172447,80622,733,810,41,71
2019년1분기,골목상권,한천로140길,강북구,수유3동,299132,1767,82,155272,143857,213052,86077,867,900,40,42
2019년2분기,골목상권,한천로140길,강북구,수유3동,353694,1767,37,181214,172477,249380,104319,867,900,24,13
2019년1분기,골목상권,노해로60길,도봉구,쌍문3동,352479,1796,389,164114,188367,258816,93659,871,925,168,221
2019년2분기,골목상권,노해로60길,도봉구,쌍문3동,486058,1796,184,224068,261990,333643,152414,871,925,99,85
2019년1분기,골목상권,노해로63다길,도봉구,창5동,66494,1912,114,33764,32729,47688,18803,949,963,48,66
2019년2분기,골목상권,노해로63다길,도봉구,창5동,80927,1912,34,40540,40391,56534,24395,949,963,13,21
2019년1분기,골목상권,신도림로13길,구로구,신도림동,79337,517,406,45075,34262,57186,22154,258,259,254,152
2019년2분기,골목상권,신도림로13길,구로구,신도림동,94574,517,129,51060,43512,67944,26630,258,259,85,44
2019년1분기,골목상권,오류로8길,구로구,오류2동,257763,2099,489,132032,125732,178580,79186,1053,1046,190,299
2019년2분기,골목상권,오류로8길,구로구,오류2동,296888,2099,478,149612,147278,201934,94957,1053,1046,232,246
2019년1분기,골목상권,우마길,구로구,가리봉동,73522,830,36,45538,27981,53462,20059,469,361,26,10
2019년2분기,골목상권,우마길,구로구,가리봉동,91419,830,44,56051,35369,65992,25428,469,361,21,23
2019년1분기,골목상권,중앙로15길,구로구,고척2동,57637,1606,133,30388,27248,42135,15500,819,787,72,61
2019년2분기,골목상권,중앙로15길,구로구,고척2동,78284,1606,157,40570,37714,53297,24983,819,787,99,58
2019년1분기,골목상권,도림천로21길,영등포구,대림2동,345707,2485,210,181398,164306,245530,100179,1224,1261,138,72
2019년2분기,골목상권,도림천로21길,영등포구,대림2동,402884,2485,228,210794,192092,283812,119070,1224,1261,152,76
2019년1분기,골목상권,도신로15길,영등포구,도림동,426263,3610,510,217892,208370,300178,126081,1795,1815,298,212
2019년2분기,골목상권,도신로15길,영등포구,도림동,363686,3610,483,189375,174312,247279,116409,1795,1815,288,195
2019년1분기,골목상권,도신로29길,영등포구,도림동,124348,1619,139,55814,68537,85661,38686,818,801,52,87
2019년2분기,골목상권,도신로29길,영등포구,도림동,140128,1619,114,62146,77983,94176,45953,818,801,52,62
2019년1분기,골목상권,도신로60길,영등포구,신길1동,165829,800,239,83911,81918,123519,42313,408,392,89,150
2019년2분기,골목상권,도신로60길,영등포구,신길1동,199791,800,83,103431,96362,148650,51143,408,392,49,34
2019년1분기,골목상권,사당로30길,동작구,사당1동,396292,1022,474,195085,201206,291424,104869,484,538,257,217
2019년2분기,골목상권,사당로30길,동작구,사당1동,450828,1022,329,218080,232746,328879,121949,484,538,184,145
2019년1분기,골목상권,사당로8길,동작구,사당5동,107627,2608,163,52712,54915,76260,31371,1233,1375,83,80
2019년2분기,골목상권,사당로8길,동작구,사당5동,137320,2608,127,64254,73067,95589,41729,1233,1375,62,65
2019년1분기,골목상권,상도로15길,동작구,상도2동,270814,3901,452,136031,134783,189128,81688,1890,2011,203,249
2019년2분기,골목상권,상도로15길,동작구,상도2동,311921,3901,368,151993,159927,215937,95984,1890,2011,150,218
2019년1분기,골목상권,초록마을로8길,강서구,화곡본동,136903,4948,97,59559,77341,98151,38745,2440,2508,24,73
2019년2분기,골목상권,초록마을로8길,강서구,화곡본동,170959,4948,130,79896,91061,118684,52271,2440,2508,65,65
2019년1분기,골목상권,초원로16길,강서구,방화1동,162192,3533,298,89650,72539,113081,49114,1798,1735,95,203
2019년2분기,골목상권,초원로16길,강서구,방화1동,182727,3533,283,98125,84603,126098,56628,1798,1735,122,161
2019년1분기,골목상권,화곡로13길,양천구,신월5동,99755,3440,203,52542,47216,68887,30873,1659,1781,86,117
2019년2분기,골목상권,화곡로13길,양천구,신월5동,115977,3440,478,59903,56076,78561,37418,1659,1781,348,130
2019년1분기,골목상권,중앙로1길,구로구,고척1동,165099,1102,1556,83482,81618,123956,41138,568,534,955,601
2019년2분기,골목상권,중앙로1길,구로구,고척1동,188567,1102,937,93698,94869,140960,47608,568,534,692,245
2019년1분기,골목상권,가산로3길,금천구,독산1동,54490,1060,1487,33566,20925,40236,14255,668,392,1165,322
2019년2분기,골목상권,가산로3길,금천구,독산1동,65318,1060,1032,40968,24352,47979,17340,668,392,747,285
2019년1분기,골목상권,가산로5길,금천구,가산동,159137,3281,664,94071,65065,111999,47138,1909,1372,460,204
2019년2분기,골목상권,가산로5길,금천구,가산동,196303,3281,371,117778,78527,137470,58836,1909,1372,243,128
2019년1분기,골목상권,도신로62길,영등포구,신길1동,153656,1876,77,74996,78657,110089,43560,927,949,45,32
2019년2분기,골목상권,도신로62길,영등포구,신길1동,185821,1876,183,94291,91531,132383,53444,927,949,145,38
2019년1분기,골목상권,디지털로37길,영등포구,대림2동,306375,1343,269,159023,147353,201568,104816,649,694,116,153
2019년2분기,골목상권,디지털로37길,영등포구,대림2동,346171,1343,165,181797,164372,222061,124113,649,694,46,119
2019년1분기,골목상권,디지털로57길,영등포구,대림2동,204296,1463,207,105781,98511,137600,66695,703,760,86,121
2019년2분기,골목상권,디지털로57길,영등포구,대림2동,243885,1463,144,123869,120016,160651,83238,703,760,78,66
2019년1분기,골목상권,상도로37길,동작구,상도1동,96958,1330,199,48708,48249,67216,29742,639,691,88,111
2019년2분기,골목상권,상도로37길,동작구,상도1동,112995,1330,59,54033,58961,73534,39462,639,691,26,33
2019년1분기,골목상권,상도로47길,동작구,상도1동,195599,3944,221,97532,98069,137435,58162,1988,1956,156,65
2019년2분기,골목상권,상도로47길,동작구,상도1동,216076,3944,450,104892,111181,150305,65766,1988,1956,200,250
2019년1분기,골목상권,상도로61길,동작구,상도1동,291849,2305,357,171765,120082,229200,62647,1191,1114,157,200
2019년2분기,골목상권,상도로61길,동작구,상도1동,368370,2305,214,216867,151505,295961,72409,1191,1114,88,126
2019년1분기,골목상권,화곡로20길,강서구,화곡1동,211726,3353,556,110665,101063,145003,66732,1684,1669,271,285
2019년2분기,골목상권,화곡로20길,강서구,화곡1동,316368,3353,393,164852,151513,216268,100099,1684,1669,210,183
2019년1분기,골목상권,화곡로31길,강서구,우장산동,293930,3946,399,141743,152182,206359,87566,1901,2045,148,251
2019년2분기,골목상권,화곡로31길,강서구,우장산동,351340,3946,575,166213,185125,243612,107727,1901,2045,335,240
2019년1분기,골목상권,화곡로44나길,강서구,화곡6동,433027,3088,1075,232792,200234,299112,133908,1543,1545,841,234
2019년2분기,골목상권,화곡로44나길,강서구,화곡6동,491013,3088,574,254448,236567,337295,153725,1543,1545,454,120
2019년1분기,골목상권,금하로14길,금천구,시흥1동,112255,1753,80,59114,53138,77702,34552,865,888,47,33
2019년2분기,골목상권,금하로14길,금천구,시흥1동,138638,1753,102,71877,66761,94672,43967,865,888,66,36
2019년1분기,골목상권,금하로1길,금천구,독산1동,91504,1965,156,48322,43185,63024,28488,991,974,73,83
2019년2분기,골목상권,금하로1길,금천구,독산1동,110504,1965,200,58657,51847,72604,37905,991,974,149,51
2019년1분기,골목상권,금하로24길,금천구,시흥5동,20680,4338,57,10428,10249,14560,6116,2190,2148,12,45
2019년2분기,골목상권,금하로24길,금천구,시흥5동,32727,4338,176,16873,15854,22537,10196,2190,2148,103,73
2019년1분기,골목상권,남부순환로112길,금천구,가산동,216916,2288,272,125231,91683,152136,64776,1372,916,154,118
2019년2분기,골목상권,남부순환로112길,금천구,가산동,257309,2288,84,147846,109464,179999,77309,1372,916,49,35
2019년1분기,골목상권,디지털로74길,영등포구,대림1동,118631,81,88,59302,59327,81422,37207,74,7,55,33
2019년2분기,골목상권,디지털로74길,영등포구,대림1동,135240,81,11,66582,68655,92828,42405,74,7,7,4
2019년1분기,골목상권,선유로55길,영등포구,양평2동,201891,2921,795,106812,95080,153848,48044,1438,1483,423,372
2019년2분기,골목상권,선유로55길,영등포구,양평2동,245752,2921,423,128876,116875,184435,61314,1438,1483,285,138
2019년1분기,골목상권,선유서로24길,영등포구,양평1동,167561,1294,497,95443,72116,130245,37313,670,624,284,213
2019년2분기,골목상권,선유서로24길,영등포구,양평1동,191628,1294,136,107338,84289,147320,44308,670,624,91,45
2019년1분기,골목상권,상도로62길,동작구,상도1동,994060,2947,515,491105,502958,750645,243420,1430,1517,204,311
2019년2분기,골목상권,상도로62길,동작구,상도1동,1384486,2947,425,698771,685713,1058688,325799,1430,1517,265,160
2019년1분기,골목상권,서달로10길,동작구,흑석동,249339,1747,25,117246,132094,179647,69693,829,918,13,12
2019년2분기,골목상권,서달로10길,동작구,흑석동,276965,1747,68,128688,148274,197261,79704,829,918,40,28
2019년1분기,골목상권,서달로14길,동작구,흑석동,297557,380,23,151285,146273,212111,85444,176,204,12,11
2019년2분기,골목상권,서달로14길,동작구,흑석동,339329,380,21,169397,169933,241986,97346,176,204,9,12
2019년1분기,골목상권,화곡로59길,강서구,화곡6동,322386,2633,376,168911,153472,226714,95668,1276,1357,174,202
2019년2분기,골목상권,화곡로59길,강서구,화곡6동,333811,2633,798,172831,160982,234850,98956,1276,1357,527,271
2019년1분기,골목상권,화곡로64길,강서구,등촌1동,146553,4287,787,76308,70246,108183,38370,2046,2241,442,345
2019년2분기,골목상권,화곡로64길,강서구,등촌1동,178519,4287,938,92393,86129,130655,47866,2046,2241,587,351
2019년1분기,골목상권,개봉로11길,구로구,개봉3동,87747,5293,122,43451,44297,62661,25088,2602,2691,39,83
2019년2분기,골목상권,개봉로11길,구로구,개봉3동,92519,5293,178,45830,46688,64335,28185,2602,2691,84,94
2019년1분기,골목상권,독산로108길,금천구,독산3동,105715,1910,1855,53060,52654,75690,30025,988,922,1493,362
2019년2분기,골목상권,독산로108길,금천구,독산3동,120017,1910,1698,60635,59385,84602,35417,988,922,1523,175
2019년1분기,골목상권,독산로40길,금천구,시흥4동,118984,2632,208,61267,57716,83491,35495,1302,1330,81,127
2019년2분기,골목상권,독산로40길,금천구,시흥4동,142714,2632,208,67493,75221,98162,44550,1302,1330,74,134
2019년1분기,골목상권,독산로50길,금천구,시흥4동,33181,2130,109,16632,16550,22741,10442,1070,1060,51,58
2019년2분기,골목상권,독산로50길,금천구,시흥4동,46208,2130,25,19760,26449,30787,15424,1070,1060,6,19
2019년1분기,골목상권,선유서로25길,영등포구,양평1동,78455,3395,2709,46626,31831,64096,14361,1761,1634,1532,1177
2019년2분기,골목상권,선유서로25길,영등포구,양평1동,90078,3395,1702,51709,38368,72008,18073,1761,1634,1311,391
2019년1분기,골목상권,선유서로28길,영등포구,양평1동,172303,982,221,99617,72685,135975,36334,506,476,127,94
2019년2분기,골목상권,선유서로28길,영등포구,양평1동,197826,982,243,111904,85924,154132,43700,506,476,129,114
2019년1분기,골목상권,신길로17길,영등포구,신길5동,66823,2428,217,30316,36506,45654,21176,1173,1255,115,102
2019년2분기,골목상권,신길로17길,영등포구,신길5동,102823,2428,722,46625,56196,71360,31464,1173,1255,301,421
2019년1분기,골목상권,신길로39길,영등포구,신길3동,123969,1984,178,64076,59891,89191,34777,1008,976,61,117
2019년2분기,골목상권,신길로39길,영등포구,신길3동,143792,1984,68,72066,71728,101313,42480,1008,976,40,28
2019년1분기,골목상권,여의대방로22길,동작구,신대방2동,75851,2387,260,39711,36140,53752,22100,1170,1217,146,114
2019년2분기,골목상권,여의대방로22길,동작구,신대방2동,87080,2387,194,45041,42039,60593,26486,1170,1217,113,81
2019년1분기,골목상권,여의대방로22나길,동작구,신대방2동,112931,2494,70,60423,52507,81556,31375,1200,1294,26,44
2019년2분기,골목상권,여의대방로22나길,동작구,신대방2동,129029,2494,170,68943,60085,91037,37994,1200,1294,95,75
2019년1분기,골목상권,여의대방로22카길,동작구,신대방2동,136489,3185,330,66060,70430,96008,40481,1556,1629,169,161
2019년2분기,골목상권,여의대방로22카길,동작구,신대방2동,161519,3185,183,77489,84033,112397,49121,1556,1629,139,44
2019년1분기,골목상권,개봉로17길,구로구,개봉2동,129767,5679,104,63002,66766,86995,42769,2781,2898,48,56
2019년2분기,골목상권,개봉로17길,구로구,개봉2동,145277,5679,1349,67162,78112,94856,50421,2781,2898,442,907
2019년1분기,골목상권,개봉로17다길,구로구,개봉2동,116321,3350,194,60201,56122,80447,35873,1670,1680,73,121
2019년2분기,골목상권,개봉로17다길,구로구,개봉2동,130196,3350,2174,65716,64481,88452,41744,1670,1680,1501,673
2019년1분기,골목상권,개봉로1길,구로구,개봉3동,174301,2206,67,85681,88619,123780,50520,1109,1097,40,27
2019년2분기,골목상권,개봉로1길,구로구,개봉3동,199945,2206,179,99054,100891,138348,61596,1109,1097,124,55
2019년1분기,골목상권,독산로64길,금천구,독산2동,85547,2243,306,44047,41503,60104,25441,1139,1104,187,119
2019년2분기,골목상권,독산로64길,금천구,독산2동,109645,2243,320,54460,55189,74704,34941,1139,1104,275,45
2019년1분기,골목상권,독산로70길,금천구,독산4동,120073,2598,175,62017,58056,84098,35977,1316,1282,62,113
2019년2분기,골목상권,독산로70길,금천구,독산4동,154657,2598,79,77723,76937,106434,48224,1316,1282,26,53
2019년1분기,골목상권,독산로78다길,금천구,독산4동,299105,3279,111,157076,142030,207200,91898,1656,1623,51,60
2019년2분기,골목상권,독산로78다길,금천구,독산4동,348202,3279,504,181354,166842,237708,110489,1656,1623,343,161
2019년1분기,골목상권,독산로85길,금천구,독산3동,29917,649,90,17323,12593,20274,9643,318,331,37,53
2019년2분기,골목상권,독산로85길,금천구,독산3동,35010,649,45,19302,15709,23170,11839,318,331,23,22
2019년1분기,골목상권,신길로42가길,영등포구,신길1동,333529,3964,67,170721,162811,230953,102581,1929,2035,25,42
2019년2분기,골목상권,신길로42가길,영등포구,신길1동,369851,3964,220,198005,171841,250912,118934,1929,2035,99,121
2019년1분기,골목상권,신길로42길,영등포구,신길4동,250644,2737,214,130721,119925,174273,76372,1382,1355,77,137
2019년2분기,골목상권,신길로42길,영등포구,신길4동,276369,2737,462,141439,134933,188044,88324,1382,1355,240,222
2019년1분기,골목상권,신길로60길,영등포구,영등포본동,309558,2997,136,167866,141699,224238,85329,1487,1510,58,78
2019년2분기,골목상권,신길로60길,영등포구,영등포본동,360920,2997,256,187608,173311,255527,105399,1487,1510,195,61
2019년1분기,골목상권,서달로15길,동작구,흑석동,587747,363,170,308476,279274,450266,137481,191,172,59,111
2019년2분기,골목상권,서달로15길,동작구,흑석동,794152,363,56,409606,384546,618152,175998,191,172,20,36
2019년1분기,골목상권,서달로8가길,동작구,흑석동,395269,630,137,189379,205892,325528,69743,305,325,60,77
2019년2분기,골목상권,서달로8가길,동작구,흑석동,525309,630,107,250402,274908,436544,88765,305,325,45,62
2019년1분기,골목상권,성대로1길,동작구,상도4동,156100,1125,410,76290,79812,111651,44451,554,571,152,258
2019년2분기,골목상권,성대로1길,동작구,상도4동,165895,1125,79,81094,84802,117413,48481,554,571,45,34
2019년1분기,골목상권,개봉로20길,구로구,개봉2동,114871,3693,453,56171,58698,79208,35660,1760,1933,189,264
2019년2분기,골목상권,개봉로20길,구로구,개봉2동,135919,3693,3242,67094,68824,92627,43296,1760,1933,1499,1743
2019년1분기,골목상권,개봉로23가길,구로구,개봉1동,245797,2487,857,121643,124153,172043,73755,1224,1263,511,346
2019년2분기,골목상권,개봉로23가길,구로구,개봉1동,304860,2487,834,151039,153820,209536,95321,1224,1263,597,237
2019년1분기,골목상권,개봉로2길,구로구,개봉3동,132341,2287,3645,64434,67906,93198,39141,1086,1201,2157,1488
2019년2분기,골목상권,개봉로2길,구로구,개봉3동,148601,2287,240,70383,78217,102463,46138,1086,1201,127,113
2019년1분기,골목상권,문성로5길,금천구,독산3동,132757,3269,216,71116,61640,93670,39090,1649,1620,105,111
2019년2분기,골목상권,문성로5길,금천구,독산3동,148262,3269,107,76535,71728,104053,44216,1649,1620,67,40
2019년1분기,골목상권,범안로11길,금천구,독산1동,83678,1269,3300,51808,31872,65870,17809,724,545,2210,1090
2019년2분기,골목상권,범안로11길,금천구,독산1동,101144,1269,1827,62341,38804,79356,21789,724,545,988,839
2019년1분기,골목상권,범안로17길,금천구,독산1동,77292,1258,903,46398,30894,56981,20311,674,584,631,272
2019년2분기,골목상권,범안로17길,금천구,독산1동,94881,1258,4343,57256,37625,69738,25144,674,584,2744,1599
2019년1분기,골목상권,양평로19길,영등포구,양평2동,284405,3234,5726,160192,124212,228691,55717,1627,1607,4125,1601
2019년2분기,골목상권,양평로19길,영등포구,양평2동,339855,3234,1345,188709,151148,271592,68258,1627,1607,865,480
2019년1분기,골목상권,양평로22라길,영등포구,양평2동,51572,1552,1980,31423,20149,46094,5478,760,792,1233,747
2019년2분기,골목상권,양평로22라길,영등포구,양평2동,72423,1552,663,42648,29775,62201,10225,760,792,352,311
2019년1분기,골목상권,양평로28길,영등포구,양평2동,119634,4135,753,66572,53066,85049,34583,2106,2029,535,218
2019년2분기,골목상권,양평로28길,영등포구,양평2동,150697,4135,908,78677,72017,105961,44738,2106,2029,712,196
2019년1분기,골목상권,여의대방로35길,영등포구,신길6동,170667,1533,363,92553,78112,127084,43574,795,738,187,176
2019년2분기,골목상권,여의대방로35길,영등포구,신길6동,226810,1533,212,123343,103460,165340,61463,795,738,70,142
2019년1분기,골목상권,성대로29길,동작구,상도4동,72202,2051,69,36211,35992,49440,22759,988,1063,25,44
2019년2분기,골목상권,성대로29길,동작구,상도4동,87719,2051,266,42359,45357,59064,28652,988,1063,130,136
2019년1분기,골목상권,신대방길,동작구,신대방1동,196600,3860,244,98202,98399,140531,56076,1858,2002,90,154
2019년2분기,골목상권,신대방길,동작구,신대방1동,238959,3860,180,115777,123186,168642,70320,1858,2002,88,92
2019년1분기,골목상권,양녕로26길,동작구,상도4동,216549,1926,137,102191,114360,149479,67076,934,992,46,91
2019년2분기,골목상권,양녕로26길,동작구,상도4동,262399,1926,92,124675,137724,178526,83873,934,992,54,38
2019년1분기,골목상권,개봉로3길,구로구,개봉3동,125280,2996,267,62858,62424,87517,37763,1467,1529,130,137
2019년2분기,골목상권,개봉로3길,구로구,개봉3동,142674,2996,331,70915,71759,97214,45462,1467,1529,156,175
2019년1분기,골목상권,경인로15길,구로구,오류1동,77416,3435,281,43081,34330,52082,25331,1716,1719,130,151
2019년2분기,골목상권,경인로15길,구로구,오류1동,99524,3435,258,49588,49933,65757,33757,1716,1719,96,162
2019년1분기,골목상권,경인로31길,구로구,개봉1동,107483,1833,117,59243,48240,74226,33253,957,876,37,80
2019년2분기,골목상권,경인로31길,구로구,개봉1동,133438,1833,119,70128,63311,90370,43071,957,876,58,61
2019년1분기,골목상권,벚꽃로56길,금천구,가산동,106143,1055,356,65250,40893,86877,19266,573,482,286,70
2019년2분기,골목상권,벚꽃로56길,금천구,가산동,133101,1055,88,81985,51112,109015,24082,573,482,65,23
2019년1분기,골목상권,시흥대로120길,금천구,독산4동,124000,3305,315,69611,54385,85683,38316,1662,1643,115,200
2019년2분기,골목상권,시흥대로120길,금천구,독산4동,130704,3305,175,69463,61238,87218,43489,1662,1643,115,60
2019년1분기,골목상권,시흥대로138길,금천구,독산3동,156672,576,395,84292,72383,115291,41385,310,266,255,140
2019년2분기,골목상권,시흥대로138길,금천구,독산3동,194199,576,358,104460,89736,142870,51327,310,266,270,88
2019년1분기,골목상권,시흥대로141길,금천구,독산1동,137726,2252,637,78604,59120,100342,37385,1241,1011,341,296
2019년2분기,골목상권,시흥대로141길,금천구,독산1동,173546,2252,316,98213,75332,125511,48036,1241,1011,217,99
2019년1분기,골목상권,여의대방로39길,영등포구,신길7동,63386,371,178,34673,28712,46119,17261,173,198,106,72
2019년2분기,골목상권,여의대방로39길,영등포구,신길7동,78929,371,163,42364,36565,55731,23198,173,198,96,67
2019년1분기,골목상권,여의대방로43나길,영등포구,신길7동,232750,3542,912,118370,114381,161723,71023,1773,1769,623,289
2019년2분기,골목상권,여의대방로43나길,영등포구,신길7동,274593,3542,935,138344,136247,186012,88583,1773,1769,742,193
2019년1분기,골목상권,여의대방로61길,영등포구,신길1동,142097,2311,438,78819,63279,104820,37279,1165,1146,313,125
2019년2분기,골목상권,여의대방로61길,영등포구,신길1동,169344,2311,1117,92368,76976,123482,45864,1165,1146,767,350
2019년1분기,골목상권,여의대방로24길,동작구,대방동,184157,2873,1107,101104,83053,134026,50137,1347,1526,677,430
2019년2분기,골목상권,여의대방로24길,동작구,대방동,226882,2873,15790,122478,104408,162480,64399,1347,1526,10229,5561
2019년1분기,골목상권,여의대방로46길,동작구,대방동,185718,2872,1325,89949,95769,135899,49819,1334,1538,584,741
2019년2분기,골목상권,여의대방로46길,동작구,대방동,216793,2872,1202,104279,112513,157294,59495,1334,1538,739,463
2019년1분기,골목상권,장승배기로10길,동작구,상도2동,189055,383,500,93479,95578,141280,47774,206,177,325,175
2019년2분기,골목상권,장승배기로10길,동작구,상도2동,247615,383,109,117580,130037,182500,65118,206,177,72,37
2019년1분기,골목상권,경인로35길,구로구,개봉1동,128445,3027,251,68395,60056,85512,42938,1562,1465,91,160
2019년2분기,골목상권,경인로35길,구로구,개봉1동,153528,3027,421,83223,70301,100934,52590,1562,1465,252,169
2019년1분기,골목상권,경인로47길,구로구,고척1동,378100,2030,661,209461,168637,279004,99095,1002,1028,183,478
2019년2분기,골목상권,경인로47길,구로구,고척1동,498372,2030,669,300100,198271,379393,118976,1002,1028,279,390
2019년1분기,골목상권,고척로21나길,구로구,개봉1동,78622,2594,194,39424,39195,53430,25189,1345,1249,89,105
2019년2분기,골목상권,고척로21나길,구로구,개봉1동,58042,2594,347,29666,28375,37821,20229,1345,1249,184,163
2019년1분기,골목상권,시흥대로150길,금천구,독산3동,182453,4814,220,101149,81300,128851,53599,2437,2377,103,117
2019년2분기,골목상권,시흥대로150길,금천구,독산3동,208875,4814,354,112189,96685,146168,62704,2437,2377,227,127
2019년1분기,골목상권,시흥대로153길,금천구,가산동,158713,1824,195,89019,69697,111593,47121,1020,804,80,115
2019년2분기,골목상권,시흥대로153길,금천구,가산동,201562,1824,100,109828,91731,140999,60565,1020,804,63,37
2019년1분기,골목상권,시흥대로22길,금천구,시흥3동,55544,3530,323,36948,18595,44343,11205,1762,1768,190,133
2019년2분기,골목상권,시흥대로22길,금천구,시흥3동,69914,3530,233,43073,26838,55178,14744,1762,1768,119,114
2019년1분기,골목상권,영등포로25길,영등포구,당산1동,258096,1829,556,144247,113853,183276,74823,930,899,370,186
2019년2분기,골목상권,영등포로25길,영등포구,당산1동,299408,1829,1488,158099,141309,211982,87426,930,899,919,569
2019년1분기,골목상권,영등포로27길,영등포구,당산1동,97263,1825,492,53464,43801,66955,30310,1003,822,278,214
2019년2분기,골목상권,영등포로27길,영등포구,당산1동,113328,1825,453,61100,52227,78325,35003,1003,822,281,172
2019년1분기,골목상권,영등포로35길,영등포구,영등포동,160386,1332,547,89430,70954,112342,48043,764,568,317,230
2019년2분기,골목상권,영등포로35길,영등포구,영등포동,195190,1332,270,107166,88026,135690,59500,764,568,137,133
2019년1분기,골목상권,공항대로42길,강서구,우장산동,148195,1139,501,73260,74935,105111,43088,564,575,306,195
2019년2분기,골목상권,공항대로42길,강서구,우장산동,181638,1139,477,87078,94564,126508,55124,564,575,302,175
2019년1분기,골목상권,공항대로55길,강서구,등촌1동,78050,1756,911,40737,37313,57187,20864,879,877,594,317
2019년2분기,골목상권,공항대로55길,강서구,등촌1동,95504,1756,741,48544,46961,69105,26403,879,877,448,293
2019년1분기,골목상권,공항대로59길,강서구,등촌1동,91728,2216,1296,50205,41521,68814,22914,1033,1183,819,477
2019년2분기,골목상권,공항대로59길,강서구,등촌1동,119931,2216,839,65564,54368,90168,29767,1033,1183,584,255
2019년1분기,골목상권,고척로27길,구로구,개봉1동,172348,2513,202,81696,90653,121745,50607,1286,1227,105,97
2019년2분기,골목상권,고척로27길,구로구,개봉1동,217096,2513,325,106404,110693,148996,68103,1286,1227,192,133
2019년1분기,골목상권,고척로27다길,구로구,고척2동,77463,4462,105,33895,43567,54372,23089,2211,2251,32,73
2019년2분기,골목상권,고척로27다길,구로구,고척2동,105265,4462,181,50048,55217,71125,34141,2211,2251,111,70
2019년1분기,골목상권,고척로52길,구로구,고척1동,157901,3170,90,82788,75110,104415,53486,1579,1591,45,45
2019년2분기,골목상권,고척로52길,구로구,고척1동,184834,3170,64,96243,88589,122753,62078,1579,1591,41,23
2019년1분기,골목상권,시흥대로36길,금천구,시흥3동,60101,1984,277,34225,25872,45383,14719,1017,967,137,140
2019년2분기,골목상권,시흥대로36길,금천구,시흥3동,72151,1984,571,39865,32284,54082,18068,1017,967,405,166
2019년1분기,골목상권,시흥대로62가길,금천구,시흥1동,171020,3026,131,89950,81070,116584,54433,1521,1505,33,98
2019년2분기,골목상권,시흥대로62가길,금천구,시흥1동,209952,3026,130,107744,102205,143862,66092,1521,1505,83,47
2019년1분기,골목상권,시흥대로63길,금천구,시흥1동,176013,1584,2087,94337,81678,125684,50334,783,801,1051,1036
2019년2분기,골목상권,시흥대로63길,금천구,시흥1동,192741,1584,1679,100098,92643,136601,56141,783,801,865,814
2019년1분기,골목상권,영등포로62길,영등포구,영등포본동,106758,1623,231,52407,54355,77930,28832,849,774,107,124
2019년2분기,골목상권,영등포로62길,영등포구,영등포본동,138021,1623,113,71279,66741,99554,38472,849,774,80,33
2019년1분기,골목상권,영등포로80길,영등포구,신길1동,284604,2232,64,144514,140089,208465,76138,1160,1072,35,29
2019년2분기,골목상권,영등포로80길,영등포구,신길1동,324240,2232,159,167685,156558,236899,87347,1160,1072,86,73
2019년1분기,골목상권,영등포로84길,영등포구,신길1동,501716,2665,1150,247183,254533,364492,137219,1348,1317,316,834
2019년2분기,골목상권,영등포로84길,영등포구,신길1동,578018,2665,2014,286075,291944,414533,163486,1348,1317,690,1324
2019년1분기,골목상권,영신로9길,영등포구,영등포본동,272438,2590,325,149611,122825,187417,85026,1342,1248,200,125
2019년2분기,골목상권,영신로9길,영등포구,영등포본동,334164,2590,1423,180290,153873,222567,111599,1342,1248,811,612
2019년1분기,골목상권,공항대로59다길,강서구,염창동,254772,3109,895,127812,126963,189679,65095,1524,1585,496,399
2019년2분기,골목상권,공항대로59다길,강서구,염창동,323555,3109,1046,156905,166651,237104,86449,1524,1585,654,392
2019년1분기,골목상권,공항대로61길,강서구,염창동,214486,2010,335,108400,106087,160125,54361,994,1016,255,80
2019년2분기,골목상권,공항대로61길,강서구,염창동,257842,2010,498,129047,128793,191948,65899,994,1016,387,111
2019년1분기,골목상권,공항대로8길,강서구,공항동,173480,3118,427,94194,79285,125213,48273,1603,1515,204,223
2019년2분기,골목상권,공항대로8길,강서구,공항동,273757,3118,276,145954,127804,194724,79034,1603,1515,190,86
2019년1분기,골목상권,국회대로7길,강서구,화곡2동,99981,2331,452,49597,50384,70838,29147,1124,1207,263,189
2019년2분기,골목상권,국회대로7길,강서구,화곡2동,125860,2331,226,60689,65170,87226,38628,1124,1207,112,114
2019년1분기,골목상권,공원로6가길,구로구,구로5동,265834,2119,1325,134592,131245,182047,83787,931,1188,864,461
2019년2분기,골목상권,공원로6가길,구로구,구로5동,308269,2119,1447,154829,153441,210483,97786,931,1188,1065,382
2019년1분기,골목상권,구로동로15길,구로구,구로2동,39987,982,101,24292,15695,25519,14473,507,475,51,50
2019년2분기,골목상권,구로동로15길,구로구,구로2동,59975,982,108,32808,27168,38271,21702,507,475,58,50
2019년1분기,골목상권,구로동로28길,구로구,구로2동,104870,2031,57,56766,48105,72841,32029,1023,1008,21,36
2019년2분기,골목상권,구로동로28길,구로구,구로2동,116131,2031,24,60432,55698,79080,37050,1023,1008,15,9
2019년1분기,골목상권,구로동로38길,구로구,구로2동,296936,1903,348,155238,141699,221376,75560,940,963,105,243
2019년2분기,골목상권,구로동로38길,구로구,구로2동,342210,1903,386,178873,163334,252960,89248,940,963,162,224
2019년1분기,골목상권,시흥대로68길,금천구,시흥1동,129802,2653,1287,64412,65389,89792,40010,1364,1289,321,966
2019년2분기,골목상권,시흥대로68길,금천구,시흥1동,162438,2653,557,80606,81834,111707,50730,1364,1289,213,344
2019년1분기,골목상권,시흥대로84길,금천구,독산2동,139292,5951,133,70918,68377,95111,44173,3031,2920,71,62
2019년2분기,골목상권,시흥대로84길,금천구,독산2동,176192,5951,192,87689,88504,116518,59672,3031,2920,114,78
2019년1분기,골목상권,시흥대로94길,금천구,독산2동,211089,3748,294,117421,93666,148971,62117,1915,1833,118,176
2019년2분기,골목상권,시흥대로94길,금천구,독산2동,245075,3748,429,131902,113174,169452,75618,1915,1833,147,282
2019년1분기,골목상권,국사봉1길,동작구,상도3동,275262,3340,182,138976,136287,193452,81814,1573,1767,71,111
2019년2분기,골목상권,국사봉1길,동작구,상도3동,315651,3340,128,152113,163539,221283,94365,1573,1767,68,60
2019년1분기,골목상권,국사봉2길,동작구,신대방2동,139120,1413,55,70533,68589,97008,42116,632,781,34,21
2019년2분기,골목상권,국사봉2길,동작구,신대방2동,168506,1413,99,82677,85828,117441,51069,632,781,60,39
2019년1분기,골목상권,국사봉길,동작구,상도3동,264640,3937,281,128264,136380,182841,81798,1880,2057,78,203
2019년2분기,골목상권,국사봉길,동작구,상도3동,309509,3937,180,146711,162801,210956,98554,1880,2057,109,71
2019년1분기,골목상권,까치산로4길,강서구,화곡본동,206777,4286,164,97680,109097,146428,60349,2071,2215,55,109
2019년2분기,골목상권,까치산로4길,강서구,화곡본동,242631,4286,217,117397,125232,170597,72032,2071,2215,123,94
2019년1분기,골목상권,남부순환로11길,강서구,공항동,223930,4071,441,127459,96470,158562,65368,2135,1936,299,142
2019년2분기,골목상권,남부순환로11길,강서구,공항동,294457,4071,309,169915,124542,197532,96920,2135,1936,217,92
2019년1분기,골목상권,등촌로13길,강서구,화곡4동,91741,3936,131,42803,48937,64421,27320,1944,1992,80,51
2019년2분기,골목상권,등촌로13길,강서구,화곡4동,135851,3936,234,61056,74791,95147,40709,1944,1992,174,60
2019년1분기,골목상권,구로동로41길,구로구,구로2동,217738,2508,197,119866,97874,158447,59289,1301,1207,82,115
2019년2분기,골목상권,구로동로41길,구로구,구로2동,261102,2508,146,143669,117429,185607,75500,1301,1207,82,64
2019년1분기,골목상권,구로동로42길,구로구,구로2동,159156,1936,200,80783,78374,110700,48455,948,988,98,102
2019년2분기,골목상권,구로동로42길,구로구,구로2동,174018,1936,143,87747,86268,119072,54948,948,988,77,66
2019년1분기,골목상권,구로동로7길,구로구,가리봉동,104278,2646,138,57683,46593,71173,33107,1414,1232,77,61
2019년2분기,골목상권,구로동로7길,구로구,가리봉동,120031,2646,119,64038,55996,79422,40611,1414,1232,74,45
2019년1분기,골목상권,가마산로61길,영등포구,신길3동,175466,1912,117,90126,85341,122641,52827,971,941,82,35
2019년2분기,골목상권,가마산로61길,영등포구,신길3동,214802,1912,53,108943,105859,147975,66829,971,941,37,16
2019년1분기,골목상권,경인로77길,영등포구,문래동,156345,269,1318,86544,69798,117060,39289,163,106,881,437
2019년2분기,골목상권,경인로77길,영등포구,문래동,197467,269,845,107237,90229,146597,50870,163,106,570,275
2019년1분기,골목상권,경인로80길,영등포구,문래동,94909,152,1766,54580,40327,72056,22858,88,64,1254,512
2019년2분기,골목상권,경인로80길,영등포구,문래동,113752,152,849,64779,48972,85144,28607,88,64,578,271
2019년1분기,골목상권,경인로90길,영등포구,문래동,99578,141,547,57989,41588,81944,17634,108,33,414,133
2019년2분기,골목상권,경인로90길,영등포구,문래동,127849,141,317,72458,55390,104910,22938,108,33,236,81
2019년1분기,골목상권,노량진로6길,동작구,노량진2동,112132,3231,90,60262,51868,79570,32563,1625,1606,41,49
2019년2분기,골목상권,노량진로6길,동작구,노량진2동,126615,3231,317,66111,60504,88166,38448,1625,1606,206,111
2019년1분기,골목상권,대방동27길,동작구,대방동,208320,4113,225,104434,103887,148717,59610,2061,2052,169,56
2019년2분기,골목상권,대방동27길,동작구,대방동,254665,4113,533,125615,129052,178917,75755,2061,2052,246,287
2019년1분기,골목상권,대방동2길,동작구,대방동,192299,3564,405,98365,93932,136923,55376,1596,1968,185,220
2019년2분기,골목상권,대방동2길,동작구,대방동,225972,3564,348,113431,112540,160839,65139,1596,1968,182,166
2019년1분기,골목상권,등촌로39길,강서구,등촌2동,155629,3389,403,84294,71335,111191,44435,1696,1693,142,261
2019년2분기,골목상권,등촌로39길,강서구,등촌2동,198442,3389,355,100492,97951,138754,59684,1696,1693,152,203
2019년1분기,골목상권,등촌로51길,강서구,등촌2동,65185,2072,300,31903,33283,47661,17526,1030,1042,169,131
2019년2분기,골목상권,등촌로51길,강서구,등촌2동,73542,2072,292,36085,37455,52943,20603,1030,1042,160,132
2019년1분기,골목상권,등촌로55길,강서구,등촌2동,77835,2958,428,38681,39156,55032,22804,1423,1535,274,154
2019년2분기,골목상권,등촌로55길,강서구,등촌2동,88352,2958,437,43510,44843,62203,26153,1423,1535,322,115
2019년1분기,골목상권,구로동로8길,구로구,구로4동,509238,6114,256,267018,242223,365825,143422,3070,3044,73,183
2019년2분기,골목상권,구로동로8길,구로구,구로4동,638981,6114,387,331901,307081,453579,185408,3070,3044,177,210
2019년1분기,골목상권,구로중앙로19길,구로구,구로2동,129330,870,362,70387,58943,98080,31248,412,458,177,185
2019년2분기,골목상권,구로중앙로19길,구로구,구로2동,190350,870,585,98604,91750,144593,45762,412,458,342,243
2019년1분기,골목상권,구로중앙로28길,구로구,구로5동,246885,3257,1007,129936,116947,176057,70837,1612,1645,601,406
2019년2분기,골목상권,구로중앙로28길,구로구,구로5동,287375,3257,594,149380,137994,202863,84512,1612,1645,335,259
2019년1분기,골목상권,국회대로56길,영등포구,영등포동,253066,2712,3178,135792,117273,194665,58402,1612,1100,1840,1338
2019년2분기,골목상권,국회대로56길,영등포구,영등포동,296088,2712,3263,154140,141946,226103,69989,1612,1100,1592,1671
2019년1분기,골목상권,당산로31길,영등포구,당산1동,106595,981,1503,59480,47117,85016,21580,503,478,917,586
2019년2분기,골목상권,당산로31길,영등포구,당산1동,129977,981,1723,69911,60069,102678,27303,503,478,895,828
2019년1분기,골목상권,당산로37길,영등포구,당산2동,112075,1331,14894,59230,52843,86922,25151,628,703,6860,8034
2019년2분기,골목상권,당산로37길,영등포구,당산2동,132127,1331,1015,67112,65014,101816,30309,628,703,731,284
2019년1분기,골목상권,동작대로17길,동작구,사당1동,296735,2411,760,144241,152494,224774,71965,1122,1289,429,331
2019년2분기,골목상권,동작대로17길,동작구,사당1동,336959,2411,819,156708,180250,252877,84086,1122,1289,434,385
2019년1분기,골목상권,동작대로29길,동작구,사당2동,145188,860,255,69401,75787,102837,42353,427,433,56,199
2019년2분기,골목상권,동작대로29길,동작구,사당2동,165798,860,287,77911,87887,116007,49791,427,433,103,184
2019년1분기,골목상권,동작대로33길,동작구,사당2동,270603,2635,340,133848,136754,190224,80380,1255,1380,183,157
2019년2분기,골목상권,동작대로33길,동작구,사당2동,310859,2635,216,150605,160256,217054,93807,1255,1380,109,107
2019년1분기,골목상권,등촌로5길,강서구,화곡4동,95258,1439,306,46690,48570,68108,27152,677,762,146,160
2019년2분기,골목상권,등촌로5길,강서구,화곡4동,107693,1439,1514,50358,57335,76018,31673,677,762,501,1013
2019년1분기,골목상권,방화대로21길,강서구,공항동,133757,2475,581,76356,57405,98477,35275,1257,1218,427,154
2019년2분기,골목상권,방화대로21길,강서구,공항동,156033,2475,380,88031,68004,115193,40845,1257,1218,245,135
2019년1분기,골목상권,방화대로6라길,강서구,공항동,158306,2362,772,95095,63210,120224,38081,1221,1141,497,275
2019년2분기,골목상권,방화대로6라길,강서구,공항동,272541,2362,706,161417,111125,200893,71649,1221,1141,451,255
2019년1분기,골목상권,구로중앙로34길,구로구,구로5동,148329,1131,215,76135,72198,103500,44835,586,545,159,56
2019년2분기,골목상권,구로중앙로34길,구로구,구로5동,170484,1131,101,86009,84474,117457,53027,586,545,85,16
2019년1분기,골목상권,구로중앙로42길,구로구,신도림동,31472,922,394,22100,9370,23287,8185,500,422,294,100
2019년2분기,골목상권,구로중앙로42길,구로구,신도림동,41446,922,511,25443,16006,30559,10887,500,422,370,141
2019년1분기,골목상권,구로중앙로7길,구로구,구로4동,124906,673,198,67130,57774,85516,39388,350,323,83,115
2019년2분기,골목상권,구로중앙로7길,구로구,구로4동,145877,673,86,76480,69398,97684,48194,350,323,43,43
2019년1분기,골목상권,구로중앙로8길,구로구,구로4동,225918,2694,137,119515,106403,152328,73592,1307,1387,47,90
2019년2분기,골목상권,구로중앙로8길,구로구,구로4동,263097,2694,125,137583,125516,172763,90337,1307,1387,60,65
2019년1분기,골목상권,당산로38길,영등포구,당산2동,177914,1801,1156,96019,81895,136420,41492,818,983,757,399
2019년2분기,골목상권,당산로38길,영등포구,당산2동,207006,1801,990,107704,99304,158489,48510,818,983,730,260
2019년1분기,골목상권,당산로46길,영등포구,당산2동,261165,2217,2976,139057,122108,197866,63300,1111,1106,1859,1117
2019년2분기,골목상권,당산로46길,영등포구,당산2동,321874,2217,2538,166536,155338,239272,82604,1111,1106,1622,916
2019년1분기,골목상권,대림로22길,영등포구,대림1동,249845,4346,131,136040,113805,174389,75462,2194,2152,62,69
2019년2분기,골목상권,대림로22길,영등포구,대림1동,297202,4346,176,159418,137784,204856,92351,2194,2152,116,60
2019년1분기,골목상권,동작대로35길,동작구,사당2동,112475,2600,869,51479,60991,79947,32529,1304,1296,88,781
2019년2분기,골목상권,동작대로35길,동작구,사당2동,134424,2600,240,61828,72595,94985,39447,1304,1296,89,151
2019년1분기,골목상권,동작대로7길,동작구,사당1동,394062,3443,370,207602,186466,277792,116272,1644,1799,158,212
2019년2분기,골목상권,동작대로7길,동작구,사당1동,464324,3443,284,239913,224411,326937,137382,1644,1799,148,136
2019년1분기,골목상권,등용로14길,동작구,대방동,191686,1918,407,107964,83726,140247,51440,967,951,209,198
2019년2분기,골목상권,등용로14길,동작구,대방동,228616,1918,375,128890,99725,166068,62551,967,951,163,212
2019년1분기,골목상권,양천로14길,강서구,방화2동,164281,4264,257,86544,77737,120952,43331,2097,2167,114,143
2019년2분기,골목상권,양천로14길,강서구,방화2동,214847,4264,312,110131,104715,156336,58516,2097,2167,176,136
2019년1분기,골목상권,양천로24가길,강서구,방화1동,188989,2885,372,100560,88430,135953,53038,1440,1445,143,229
2019년2분기,골목상권,양천로24가길,강서구,방화1동,221447,2885,161,115904,105541,156857,64591,1440,1445,106,55
2019년1분기,골목상권,양천로24길,강서구,방화1동,202866,3790,266,103666,99198,146413,56452,1931,1859,88,178
2019년2분기,골목상권,양천로24길,강서구,방화1동,233045,3790,203,115437,117607,167507,65540,1931,1859,95,108
2019년1분기,골목상권,남부순환로97길,구로구,개봉2동,66007,1287,151,33861,32147,45947,20064,608,679,49,102
2019년2분기,골목상권,남부순환로97길,구로구,개봉2동,75995,1287,105,38079,37916,52430,23567,608,679,56,49
2019년1분기,골목상권,도림로12길,구로구,구로3동,274698,2165,63,144114,130586,191391,83308,1027,1138,22,41
2019년2분기,골목상권,도림로12길,구로구,구로3동,328529,2165,62,168002,160525,223080,105453,1027,1138,31,31
2019년1분기,골목상권,도림로6길,구로구,가리봉동,319021,1410,301,186242,132780,221863,97159,727,683,109,192
2019년2분기,골목상권,도림로6길,구로구,가리봉동,374012,1410,167,215657,158355,255074,118942,727,683,97,70
2019년1분기,골목상권,대림로29길,영등포구,대림3동,577683,1876,1199,310934,266751,390423,187269,974,902,673,526
2019년2분기,골목상권,대림로29길,영등포구,대림3동,676148,1876,989,364538,311613,446971,229178,974,902,662,327
2019년1분기,골목상권,대림로31길,영등포구,대림3동,121727,2369,1091,69738,51987,89512,32215,1214,1155,551,540
2019년2분기,골목상권,대림로31길,영등포구,대림3동,146039,2369,428,81237,64802,106811,39231,1214,1155,270,158
2019년1분기,골목상권,대림로34길,영등포구,대림3동,257355,2843,453,148255,109100,193690,63672,1458,1385,257,196
2019년2분기,골목상권,대림로34길,영등포구,대림3동,304801,2843,274,169710,135091,225447,79348,1458,1385,181,93
2019년1분기,골목상권,만양로14길,동작구,노량진1동,295522,921,168,168507,127015,209660,85857,559,362,95,73
2019년2분기,골목상권,만양로14길,동작구,노량진1동,332661,921,50,189478,143183,233536,99125,559,362,23,27
2019년1분기,골목상권,만양로8길,동작구,노량진1동,468813,3617,237,265338,203471,312825,155990,1847,1770,80,157
2019년2분기,골목상권,만양로8길,동작구,노량진1동,512074,3617,664,286622,225455,339730,172340,1847,1770,316,348
2019년1분기,골목상권,사당로16가길,동작구,사당4동,104104,2263,169,49880,54221,72198,31903,1079,1184,73,96
2019년2분기,골목상권,사당로16가길,동작구,사당4동,141706,2263,231,65456,76249,96825,44887,1079,1184,142,89
2019년1분기,골목상권,양천로26길,강서구,방화1동,45932,2015,279,26178,19753,32089,13845,967,1048,158,121
2019년2분기,골목상권,양천로26길,강서구,방화1동,54660,2015,516,29477,25184,37477,17183,967,1048,388,128
2019년1분기,골목상권,양천로49길,강서구,가양1동,97170,1311,770,49442,47729,72183,24988,677,634,492,278
2019년2분기,골목상권,양천로49길,강서구,가양1동,112052,1311,368,55359,56696,82847,29203,677,634,276,92
2019년1분기,골목상권,양천로71길,강서구,염창동,193404,6658,271,92837,100571,141327,52080,3249,3409,99,172
2019년2분기,골목상권,양천로71길,강서구,염창동,229450,6658,1127,108968,120488,165689,63761,3249,3409,699,428
2019년1분기,골목상권,양천로73가길,강서구,염창동,190616,2749,630,98094,92527,134202,56418,1426,1323,439,191
2019년2분기,골목상권,양천로73가길,강서구,염창동,218378,2749,474,107676,110703,152206,66172,1426,1323,363,111
2019년1분기,골목상권,디지털로27길,구로구,가리봉동,143498,1190,66,93705,49794,125590,17908,637,553,33,33
2019년2분기,골목상권,디지털로27길,구로구,가리봉동,183234,1190,58,116223,67008,156162,27069,637,553,34,24
2019년1분기,골목상권,디지털로32가길,구로구,구로3동,376423,4723,2405,204668,171757,270855,105568,2583,2140,1146,1259
2019년2분기,골목상권,디지털로32가길,구로구,구로3동,434762,4723,2779,234790,199970,317627,117137,2583,2140,1421,1358
2019년1분기,골목상권,디지털로32길,구로구,구로3동,890867,1500,1383,526233,364634,682977,207890,822,678,588,795
2019년2분기,골목상권,디지털로32길,구로구,구로3동,1049790,1500,645,604236,445555,808292,241502,822,678,346,299
2019년1분기,골목상권,부일로11길,구로구,수궁동,32073,2639,242,18341,13732,23148,8928,1349,1290,111,131
2019년2분기,골목상권,부일로11길,구로구,수궁동,56695,2639,244,28256,28436,39323,17367,1349,1290,97,147
2019년1분기,골목상권,대림로44길,영등포구,대림3동,281930,2339,612,138552,143378,210639,71296,1224,1115,298,314
2019년2분기,골목상권,대림로44길,영등포구,대림3동,332239,2339,476,163086,169152,246881,85358,1224,1115,318,158
2019년1분기,골목상권,대림로7길,영등포구,대림2동,87850,1057,122,44859,42988,60808,27040,512,545,64,58
2019년2분기,골목상권,대림로7길,영등포구,대림2동,90228,1057,70,45415,44813,59765,30459,512,545,41,29
2019년1분기,골목상권,대림로8길,영등포구,대림1동,350192,3025,473,165354,184838,244008,106185,1503,1522,207,266
2019년2분기,골목상권,대림로8길,영등포구,대림1동,350880,3025,313,165462,185419,245041,105849,1503,1522,160,153
2019년1분기,골목상권,사당로16길,동작구,사당4동,168419,3461,274,86526,81895,116393,52026,1649,1812,185,89
2019년2분기,골목상권,사당로16길,동작구,사당4동,171875,3461,77,85818,86053,118201,53673,1649,1812,38,39
2019년1분기,골목상권,사당로20길,동작구,사당1동,99455,2722,99,48828,50627,68983,30474,1296,1426,55,44
2019년2분기,골목상권,사당로20길,동작구,사당1동,117597,2722,112,59007,58590,80166,37429,1296,1426,61,51
2019년1분기,골목상권,사당로23길,동작구,사당3동,100404,1509,72,48988,51416,68635,31770,721,788,18,54
2019년2분기,골목상권,사당로23길,동작구,사당3동,129137,1509,7,62271,66866,85617,43524,721,788,6,1
2019년1분기,골목상권,우장산로6길,강서구,우장산동,381237,5368,241,168553,212682,290929,90304,2557,2811,104,137
2019년2분기,골목상권,우장산로6길,강서구,우장산동,509049,5368,325,219852,289200,382353,126688,2557,2811,215,110
2019년1분기,골목상권,월정로20길,강서구,화곡1동,283270,2545,138,146080,137187,188982,94291,1333,1212,71,67
2019년2분기,골목상권,월정로20길,강서구,화곡1동,331148,2545,126,170423,160725,219502,111649,1333,1212,24,102
2019년1분기,골목상권,초록마을로3길,강서구,화곡본동,293411,2874,251,153139,140275,203090,90325,1476,1398,107,144
2019년2분기,골목상권,초록마을로3길,강서구,화곡본동,333791,2874,471,175862,157930,226677,107107,1476,1398,367,104
2019년1분기,골목상권,부일로15길,구로구,수궁동,71640,1686,174,36540,35098,46050,25594,825,861,109,65
2019년2분기,골목상권,부일로15길,구로구,수궁동,104776,1686,200,53701,51073,67329,37442,825,861,128,72
2019년1분기,골목상권,부일로1길,구로구,수궁동,53071,1428,499,28489,24582,37150,15918,716,712,419,80
2019년2분기,골목상권,부일로1길,구로구,수궁동,73491,1428,665,37226,36265,50797,22694,716,712,618,47
2019년1분기,골목상권,새말로18길,구로구,구로5동,97169,2823,560,50399,46770,67643,29525,1373,1450,342,218
2019년2분기,골목상권,새말로18길,구로구,구로5동,120144,2823,437,61493,58653,81149,38997,1373,1450,293,144
2019년1분기,골목상권,도림로112길,영등포구,도림동,227790,2249,125,109460,118333,159729,68067,1171,1078,69,56
2019년2분기,골목상권,도림로112길,영등포구,도림동,248117,2249,37,120320,127796,169236,78883,1171,1078,24,13
2019년1분기,골목상권,도림로147길,영등포구,문래동,108070,341,689,63661,44408,81363,26706,187,154,494,195
2019년2분기,골목상권,도림로147길,영등포구,문래동,129751,341,333,74656,55094,97275,32474,187,154,255,78
2019년1분기,골목상권,도림로63길,영등포구,신길5동,91680,602,75,54120,37560,64551,27132,306,296,41,34
2019년2분기,골목상권,도림로63길,영등포구,신길5동,113121,602,59,63840,49280,78129,34992,306,296,48,11
2019년1분기,골목상권,사당로23나길,동작구,사당3동,42159,1000,133,18266,23897,29755,12406,497,503,108,25
2019년2분기,골목상권,사당로23나길,동작구,사당3동,49737,1000,32,20577,29160,34395,15343,497,503,20,12
2019년1분기,골목상권,사당로26길,동작구,사당1동,66503,2886,208,29322,37181,44052,22453,1392,1494,94,114
2019년2분기,골목상권,사당로26길,동작구,사당1동,88597,2886,342,42052,46546,59547,29053,1392,1494,243,99
2019년1분기,골목상권,사당로29길,동작구,사당3동,44273,2570,181,24074,20198,29651,14623,1227,1343,112,69
2019년2분기,골목상권,사당로29길,동작구,사당3동,58148,2570,134,29832,28318,38389,19761,1227,1343,76,58
2019년1분기,골목상권,사당로2차길,동작구,사당5동,138856,3211,343,67775,71081,99143,39715,1554,1657,236,107
2019년2분기,골목상권,사당로2차길,동작구,사당5동,164393,3211,728,79680,84717,116202,48191,1554,1657,535,193
2019년1분기,골목상권,통일로11길,서대문구,천연동,47125,288,120,22100,25025,34259,12867,158,130,51,69
2019년2분기,골목상권,통일로11길,서대문구,천연동,56580,288,76,25560,31020,40796,15785,158,130,30,46
2019년1분기,골목상권,통일로37길,서대문구,홍제1동,84432,1624,239,38072,46361,59751,24681,739,885,82,157
2019년2분기,골목상권,통일로37길,서대문구,홍제1동,99521,1624,722,46810,52711,70043,29477,739,885,448,274
2019년1분기,골목상권,통일로39길,서대문구,홍제1동,337790,1597,159,158619,179173,248794,88999,791,806,68,91
2019년2분기,골목상권,통일로39길,서대문구,홍제1동,406490,1597,53,188341,218151,296448,110045,791,806,24,29
2019년1분기,골목상권,월드컵로7길,마포구,합정동,133415,1873,728,61557,71859,92778,40635,854,1019,471,257
2019년2분기,골목상권,월드컵로7길,마포구,합정동,157966,1873,739,72177,85789,109556,48409,854,1019,286,453
2019년1분기,골목상권,월드컵로8길,마포구,서교동,337851,1609,1505,162059,175793,245398,92451,721,888,790,715
2019년2분기,골목상권,월드컵로8길,마포구,서교동,403492,1609,1502,191131,212357,290341,113146,721,888,712,790
2019년1분기,골목상권,토정로37길,마포구,용강동,119908,2607,457,59451,60453,92680,27229,1255,1352,230,227
2019년2분기,골목상권,토정로37길,마포구,용강동,145298,2607,291,68658,76640,110875,34423,1255,1352,143,148
2019년1분기,골목상권,강서로15길,강서구,화곡1동,223712,5446,416,105040,118671,154253,69459,2684,2762,206,210
2019년2분기,골목상권,강서로15길,강서구,화곡1동,252455,5446,256,111886,140571,171574,80881,2684,2762,165,91
2019년1분기,골목상권,강서로17가길,강서구,화곡1동,106334,3205,192,51300,55033,74157,32176,1609,1596,68,124
2019년2분기,골목상권,강서로17가길,강서구,화곡1동,115684,3205,562,53689,61996,78383,37300,1609,1596,397,165
2019년1분기,골목상권,강서로18길,강서구,화곡8동,166316,6868,138,79318,86994,113182,53131,3311,3557,54,84
2019년2분기,골목상권,강서로18길,강서구,화곡8동,311247,6868,690,147008,164242,223042,88203,3311,3557,539,151
2019년1분기,골목상권,연서로21길,은평구,갈현2동,330312,4250,292,153455,176857,230492,99819,2017,2233,126,166
2019년2분기,골목상권,연서로21길,은평구,갈현2동,392116,4250,249,174740,217376,267957,124162,2017,2233,151,98
2019년1분기,골목상권,연서로27길,은평구,갈현2동,80039,2937,389,36832,43208,56600,23439,1375,1562,117,272
2019년2분기,골목상권,연서로27길,은평구,갈현2동,114910,2937,404,53243,61669,79464,35447,1375,1562,187,217
2019년1분기,골목상권,연서로28길,은평구,대조동,307952,3669,353,150697,157258,225510,82444,1727,1942,190,163
2019년2분기,골목상권,연서로28길,은평구,대조동,384981,3669,271,182466,202516,272629,112360,1727,1942,146,125
2019년1분기,골목상권,홍연길,서대문구,연희동,175666,1084,145,89271,86393,122321,53341,563,521,92,53
2019년2분기,골목상권,홍연길,서대문구,연희동,209680,1084,79,105555,104127,144140,65547,563,521,49,30
2019년1분기,골목상권,홍제내길,서대문구,홍제1동,161134,3308,272,71311,89827,111235,49907,1536,1772,150,122
2019년2분기,골목상권,홍제내길,서대문구,홍제1동,198742,3308,280,88284,110459,134639,64099,1536,1772,131,149
2019년1분기,골목상권,광성로6길,마포구,신수동,294020,2022,608,163119,130898,218049,75970,1087,935,321,287
2019년2분기,골목상권,광성로6길,마포구,신수동,338760,2022,344,183905,154859,250181,88575,1087,935,200,144
2019년1분기,골목상권,대흥로21길,마포구,대흥동,372405,3399,310,168479,203920,278981,93419,1760,1639,142,168
2019년2분기,골목상권,대흥로21길,마포구,대흥동,430745,3399,363,193804,236939,324966,105778,1760,1639,205,158
2019년1분기,골목상권,효창원로93길,마포구,공덕동,462824,2764,775,191907,270919,356828,105997,1320,1444,436,339
2019년2분기,골목상권,효창원로93길,마포구,공덕동,630355,2764,811,227549,402804,491969,138397,1320,1444,463,348
2019년1분기,골목상권,가로공원로58길,양천구,신월3동,31814,2349,72,17651,14162,22761,9058,1297,1052,16,56
2019년2분기,골목상권,가로공원로58길,양천구,신월3동,41096,2349,113,22731,18366,28653,12444,1297,1052,65,48
2019년1분기,골목상권,곰달래로10길,양천구,신월1동,127263,3379,727,74243,53023,86893,40376,1747,1632,583,144
2019년2분기,골목상권,곰달래로10길,양천구,신월1동,151732,3379,586,85936,65795,102993,48742,1747,1632,475,111
2019년1분기,골목상권,곰달래로2길,양천구,신월1동,102469,3492,492,58305,44164,70412,32054,1787,1705,256,236
2019년2분기,골목상권,곰달래로2길,양천구,신월1동,136830,3492,571,73692,63139,93171,43665,1787,1705,321,250
2019년1분기,골목상권,강서로29길,강서구,화곡1동,231869,3091,290,110571,121297,168134,63734,1503,1588,128,162
2019년2분기,골목상권,강서로29길,강서구,화곡1동,246197,3091,392,116359,129835,176626,69572,1503,1588,223,169
2019년1분기,골목상권,강서로35길,강서구,화곡3동,152860,3923,95,73551,79310,104808,48056,1880,2043,33,62
2019년2분기,골목상권,강서로35길,강서구,화곡3동,190185,3923,324,89312,100872,128365,61821,1880,2043,160,164
2019년1분기,골목상권,강서로45길,강서구,화곡3동,173751,908,216,84189,89559,127167,46584,437,471,83,133
2019년2분기,골목상권,강서로45길,강서구,화곡3동,190435,908,82,82375,108060,136836,53602,437,471,32,50
2019년1분기,골목상권,연서로29길,은평구,갈현1동,129090,1065,139,59917,69172,89371,39717,498,567,68,71
2019년2분기,골목상권,연서로29길,은평구,갈현1동,171902,1065,96,77386,94516,116688,55212,498,567,64,32
2019년1분기,골목상권,연서로33길,은평구,불광2동,219780,2073,57,104947,114830,156546,63237,1005,1068,13,44
2019년2분기,골목상권,연서로33길,은평구,불광2동,122265,2073,111,60987,61279,85005,37263,1005,1068,49,62
2019년1분기,골목상권,연서로34길,은평구,불광2동,256695,3000,133,127350,129346,182562,74130,1421,1579,41,92
2019년2분기,골목상권,연서로34길,은평구,불광2동,240683,3000,1175,121158,119526,168578,72104,1421,1579,602,573
2019년1분기,골목상권,대흥로28길,마포구,염리동,285950,1418,162,131630,154323,217130,68819,687,731,97,65
2019년2분기,골목상권,대흥로28길,마포구,염리동,344337,1418,97,161271,183064,263661,80670,687,731,50,47
2019년1분기,골목상권,도화4길,마포구,도화동,168833,3546,453,83304,85529,125280,43553,1677,1869,184,269
2019년2분기,골목상권,도화4길,마포구,도화동,202537,3546,687,100065,102471,148394,54144,1677,1869,298,389
2019년1분기,골목상권,도화길,마포구,도화동,407036,1081,371,222846,184191,316707,90329,462,619,167,204
2019년2분기,골목상권,도화길,마포구,도화동,469464,1081,57,251519,217944,363112,106348,462,619,27,30
2019년1분기,골목상권,곰달래로3길,양천구,신월1동,187747,3853,305,95268,92484,132942,54807,2012,1841,141,164
2019년2분기,골목상권,곰달래로3길,양천구,신월1동,225519,3853,312,110861,114657,156971,68548,2012,1841,201,111
2019년1분기,골목상권,곰달래로5길,양천구,신월1동,93385,3724,270,50720,42666,64968,28415,1921,1803,159,111
2019년2분기,골목상권,곰달래로5길,양천구,신월1동,117018,3724,442,60965,56055,80911,36110,1921,1803,180,262
2019년1분기,골목상권,남부순환로33길,양천구,신월5동,103334,3691,133,56851,46485,73314,30022,1808,1883,57,76
2019년2분기,골목상권,남부순환로33길,양천구,신월5동,127443,3691,171,70860,56584,89734,37710,1808,1883,109,62
2019년1분기,골목상권,강서로45다길,강서구,화곡3동,216953,2720,220,105164,111792,149985,66967,1321,1399,90,130
2019년2분기,골목상권,강서로45다길,강서구,화곡3동,252972,2720,167,117711,135264,171716,81257,1321,1399,110,57
2019년1분기,골목상권,강서로47길,강서구,발산1동,199392,4329,314,89950,109443,151299,48093,2077,2252,117,197
2019년2분기,골목상권,강서로47길,강서구,발산1동,213761,4329,310,95301,118466,154803,58962,2077,2252,131,179
2019년1분기,골목상권,강서로47라길,강서구,발산1동,149222,3802,181,67373,81849,109035,40194,1771,2031,64,117
2019년2분기,골목상권,강서로47라길,강서구,발산1동,202482,3802,192,88934,113553,145200,57284,1771,2031,146,46
2019년1분기,골목상권,연서로3길,은평구,역촌동,297029,3678,120,143107,153922,210903,86128,1723,1955,46,74
2019년2분기,골목상권,연서로3길,은평구,역촌동,346720,3678,153,160650,186072,243343,103379,1723,1955,65,88
2019년1분기,골목상권,연서로41길,은평구,불광2동,237654,3959,194,124273,113379,167798,69851,1922,2037,54,140
2019년2분기,골목상권,연서로41길,은평구,불광2동,298067,3959,114,151999,146070,206441,91640,1922,2037,42,72
2019년1분기,골목상권,연서로5길,은평구,역촌동,32796,2643,276,15662,17134,23400,9403,1234,1409,137,139
2019년2분기,골목상권,연서로5길,은평구,역촌동,410757,2643,583,196443,214314,294510,116243,1234,1409,226,357
2019년1분기,골목상권,은평로10길,은평구,응암1동,263394,2950,259,128258,135135,189402,73987,1467,1483,117,142
2019년2분기,골목상권,은평로10길,은평구,응암1동,325975,2950,305,153504,172468,232518,93457,1467,1483,178,127
2019년1분기,골목상권,독막로22길,마포구,서강동,142615,1024,295,73037,69578,104649,37964,476,548,95,200
2019년2분기,골목상권,독막로22길,마포구,서강동,164719,1024,100,82215,82504,118556,46160,476,548,67,33
2019년1분기,골목상권,독막로32길,마포구,신수동,161953,2812,245,78620,83333,114099,47856,1385,1427,102,143
2019년2분기,골목상권,독막로32길,마포구,신수동,173381,2812,416,84489,88893,118658,54726,1385,1427,211,205
2019년1분기,골목상권,독막로8길,마포구,합정동,162227,1353,786,81655,80571,110078,52155,626,727,476,310
2019년2분기,골목상권,독막로8길,마포구,합정동,204568,1353,575,102996,101574,139202,65365,626,727,372,203
2019년1분기,골목상권,남부순환로40길,양천구,신월3동,106160,2424,143,58382,47781,76526,29634,1333,1091,54,89
2019년2분기,골목상권,남부순환로40길,양천구,신월3동,125280,2424,152,65738,59542,88985,36297,1333,1091,69,83
2019년1분기,골목상권,남부순환로58길,양천구,신월3동,25217,2060,244,11876,13339,18151,7062,1059,1001,146,98
2019년2분기,골목상권,남부순환로58길,양천구,신월3동,32218,2060,247,14437,17784,22293,9925,1059,1001,152,95
2019년1분기,골목상권,남부순환로70길,양천구,신월7동,92739,4823,335,52574,40163,64824,27911,2378,2445,160,175
2019년2분기,골목상권,남부순환로70길,양천구,신월7동,123845,4823,253,68019,55826,84194,39650,2378,2445,138,115
2019년1분기,골목상권,남부순환로79길,양천구,신월6동,79152,710,254,48066,31082,62048,17099,358,352,115,139
2019년2분기,골목상권,남부순환로79길,양천구,신월6동,90359,710,185,54688,35675,68534,21823,358,352,77,108
2019년1분기,골목상권,강서로5가길,강서구,화곡1동,633085,2094,461,346965,286118,451041,182049,1055,1039,209,252
2019년2분기,골목상권,강서로5가길,강서구,화곡1동,678866,2094,216,360097,318769,477536,201329,1055,1039,119,97
2019년1분기,골목상권,강서로5나길,강서구,화곡1동,293651,2911,185,158934,134716,196655,96993,1452,1459,102,83
2019년2분기,골목상권,강서로5나길,강서구,화곡1동,351218,2911,378,186735,164484,234269,116953,1452,1459,232,146
2019년1분기,골목상권,강서로5라길,강서구,화곡2동,329399,2805,657,174626,154773,228775,100633,1383,1422,389,268
2019년2분기,골목상권,강서로5라길,강서구,화곡2동,376874,2805,299,196005,180870,258426,118443,1383,1422,200,99
2019년1분기,골목상권,은평로13길,은평구,녹번동,190861,3276,904,87437,103427,135512,55353,1560,1716,436,468
2019년2분기,골목상권,은평로13길,은평구,녹번동,233343,3276,661,109858,123481,163004,70335,1560,1716,309,352
2019년1분기,골목상권,은평로20길,은평구,응암1동,96247,295,28,52943,43300,71441,24805,141,154,7,21
2019년2분기,골목상권,은평로20길,은평구,응암1동,105102,295,48,59893,45209,77038,28061,141,154,9,39
2019년1분기,골목상권,은평로3길,은평구,역촌동,286854,2300,257,144917,141939,204767,82087,1073,1227,131,126
2019년2분기,골목상권,은평로3길,은평구,역촌동,292254,2300,290,143129,149125,204947,87307,1073,1227,131,159
2019년1분기,골목상권,동교로17길,마포구,서교동,155237,1852,939,76249,78987,116796,38440,861,991,539,400
2019년2분기,골목상권,동교로17길,마포구,서교동,187714,1852,459,92369,95345,141068,46647,861,991,264,195
2019년1분기,골목상권,동교로19길,마포구,서교동,223800,1803,2239,111004,112793,165087,58713,841,962,1414,825
2019년2분기,골목상권,동교로19길,마포구,서교동,259355,1803,1139,131013,128341,191762,67593,841,962,729,410
2019년1분기,골목상권,동교로25길,마포구,연남동,133026,1292,1992,63104,69921,96830,36196,565,727,1100,892
2019년2분기,골목상권,동교로25길,마포구,연남동,157753,1292,1133,73991,83761,114048,43708,565,727,701,432
2019년1분기,골목상권,남부순환로88길,양천구,신정3동,56679,1859,568,30107,26572,39270,17407,905,954,461,107
2019년2분기,골목상권,남부순환로88길,양천구,신정3동,77363,1859,965,38621,38744,52545,24818,905,954,681,284
2019년1분기,골목상권,목동남로4길,양천구,신정7동,79721,1263,274,42357,37363,53951,25771,604,659,132,142
2019년2분기,골목상권,목동남로4길,양천구,신정7동,205353,1263,886,98883,106473,138358,66996,604,659,575,311
2019년1분기,골목상권,목동동로12길,양천구,목1동,194905,2273,571,99196,95709,140883,54025,1083,1190,240,331
2019년2분기,골목상권,목동동로12길,양천구,목1동,229971,2273,389,112582,117389,162452,67521,1083,1190,228,161
2019년1분기,골목상권,곰달래로53길,강서구,화곡4동,98508,3732,136,47530,50976,67791,30712,1840,1892,49,87
2019년2분기,골목상권,곰달래로53길,강서구,화곡4동,155608,3732,147,72085,83523,105055,50555,1840,1892,94,53
2019년1분기,골목상권,곰달래로60길,강서구,화곡4동,141246,1988,412,71610,69641,100470,40779,980,1008,220,192
2019년2분기,골목상권,곰달래로60길,강서구,화곡4동,171236,1988,226,84812,86426,120669,50576,980,1008,147,79
2019년1분기,골목상권,공항대로38길,강서구,우장산동,170610,382,605,86094,84516,123611,46999,182,200,299,306
2019년2분기,골목상권,공항대로38길,강서구,우장산동,211142,382,128,103209,107931,150982,60160,182,200,91,37
2019년1분기,골목상권,은평로8길,은평구,응암1동,314817,3512,184,151472,163343,225040,89781,1689,1823,75,109
2019년2분기,골목상권,은평로8길,은평구,응암1동,335083,3512,265,162386,172699,235489,99592,1689,1823,176,89
2019년1분기,골목상권,응암로12길,은평구,응암3동,225097,1496,125,115604,109495,157028,68069,753,743,56,69
2019년2분기,골목상권,응암로12길,은평구,응암3동,293985,1496,63,147485,146504,204122,89865,753,743,38,25
2019년1분기,골목상권,응암로13길,은평구,응암3동,159266,1836,218,85231,74035,111333,47937,895,941,99,119
2019년2분기,골목상권,응암로13길,은평구,응암3동,196337,1836,129,103983,92355,136084,60252,895,941,30,99
2019년1분기,골목상권,동교로27길,마포구,연남동,323397,2480,1815,146025,177368,215059,108335,1133,1347,970,845
2019년2분기,골목상권,동교로27길,마포구,연남동,428520,2480,1193,190864,237653,279455,149066,1133,1347,731,462
2019년1분기,골목상권,동교로38길,마포구,연남동,282651,1141,1036,114633,168020,182740,99911,574,567,568,468
2019년2분기,골목상권,동교로38길,마포구,연남동,348206,1141,622,141742,206463,221788,126418,574,567,255,367
2019년1분기,골목상권,마포대로12길,마포구,아현동,106403,860,470,59197,47207,89737,16669,387,473,177,293
2019년2분기,골목상권,마포대로12길,마포구,아현동,124257,860,76,67589,56667,103962,20291,387,473,32,44
2019년1분기,골목상권,목동동로8길,양천구,신정2동,46860,1574,196,20091,26771,32486,14375,757,817,79,117
2019년2분기,골목상권,목동동로8길,양천구,신정2동,56724,1574,190,22683,34042,39260,17465,757,817,110,80
2019년1분기,골목상권,목동로19길,양천구,신정4동,470725,2288,417,249438,221289,346879,123846,1072,1216,145,272
2019년2분기,골목상권,목동로19길,양천구,신정4동,529102,2288,381,273965,255140,386243,142861,1072,1216,208,173
2019년1분기,골목상권,목동로9길,양천구,신정4동,341515,3483,1421,166997,174521,260948,80565,1659,1824,878,543
2019년2분기,골목상권,목동로9길,양천구,신정4동,375199,3483,739,185125,190073,279053,96148,1659,1824,457,282
2019년1분기,골목상권,강서로8길,강서구,화곡8동,894957,3410,616,489663,405294,645038,249919,1686,1724,217,399
2019년2분기,골목상권,강서로8길,강서구,화곡8동,943692,3410,211,502898,440795,672118,271567,1686,1724,130,81
2019년1분기,골목상권,개화동로23길,강서구,방화2동,140165,3884,762,67137,73029,99284,40882,1937,1947,549,213
2019년2분기,골목상권,개화동로23길,강서구,방화2동,183620,3884,930,94903,88717,130492,53127,1937,1947,654,276
2019년1분기,골목상권,개화동로25길,강서구,방화2동,143128,2386,210,78117,65013,100119,43008,1207,1179,131,79
2019년2분기,골목상권,개화동로25길,강서구,방화2동,191115,2386,259,106246,84867,132203,58918,1207,1179,181,78
2019년1분기,골목상권,응암로14길,은평구,응암3동,280276,2596,174,144488,135789,196116,84154,1320,1276,62,112
2019년2분기,골목상권,응암로14길,은평구,응암3동,360313,2596,92,182198,178116,250039,110281,1320,1276,56,36
2019년1분기,골목상권,응암로22길,은평구,응암3동,199021,1922,145,105481,93539,142989,56036,935,987,74,71
2019년2분기,골목상권,응암로22길,은평구,응암3동,274540,1922,126,143660,130879,193799,80739,935,987,62,64
2019년1분기,골목상권,응암로34길,은평구,응암1동,189166,2889,215,94052,95114,134661,54499,1410,1479,79,136
2019년2분기,골목상권,응암로34길,은평구,응암1동,203029,2889,225,103500,99529,142786,60253,1410,1479,119,106
2019년1분기,골목상권,마포대로20길,마포구,공덕동,587682,2121,822,283270,304412,433161,154527,1015,1106,352,470
2019년2분기,골목상권,마포대로20길,마포구,공덕동,644904,2121,680,310412,334492,476676,168232,1015,1106,364,316
2019년1분기,골목상권,마포대로4길,마포구,도화동,238505,836,1940,128526,109980,185197,53309,392,444,1267,673
2019년2분기,골목상권,마포대로4길,마포구,도화동,278826,836,1567,147006,131821,213318,65508,392,444,1015,552
2019년1분기,골목상권,만리재옛길,마포구,공덕동,262465,3048,1933,144457,118009,196893,65574,1452,1596,917,1016
2019년2분기,골목상권,만리재옛길,마포구,공덕동,319600,3048,1540,171437,148162,238069,81530,1452,1596,724,816
2019년1분기,골목상권,목동중앙남로3가길,양천구,목4동,190706,2743,513,101842,88862,137483,53225,1374,1369,189,324
2019년2분기,골목상권,목동중앙남로3가길,양천구,목4동,204196,2743,165,109596,94602,143552,60642,1374,1369,102,63
2019년1분기,골목상권,목동중앙로13나길,양천구,목2동,36524,1074,258,20171,16353,27210,9314,557,517,177,81
2019년2분기,골목상권,목동중앙로13나길,양천구,목2동,48607,1074,287,28859,19748,35633,12976,557,517,177,110
2019년1분기,골목상권,목동중앙로3길,양천구,목4동,91991,2412,50,42913,49078,64987,27002,1162,1250,17,33
2019년2분기,골목상권,목동중앙로3길,양천구,목4동,41364,2412,121,20078,21288,27534,13826,1162,1250,73,48
2019년1분기,골목상권,목동중앙본로7길,양천구,목4동,195659,2932,233,95052,100609,142012,53652,1476,1456,115,118
2019년2분기,골목상권,목동중앙본로7길,양천구,목4동,148311,2932,169,74851,73460,102935,45383,1476,1456,70,99
2019년1분기,골목상권,곰달래로25길,강서구,화곡8동,167665,2962,345,83984,83681,122120,45545,1390,1572,168,177
2019년2분기,골목상권,곰달래로25길,강서구,화곡8동,184827,2962,196,90614,94214,132737,52088,1390,1572,124,72
2019년1분기,골목상권,곰달래로31길,강서구,화곡2동,128976,3131,142,58501,70473,90360,38611,1483,1648,74,68
2019년2분기,골목상권,곰달래로31길,강서구,화곡2동,195662,3131,134,90385,105279,141560,54103,1483,1648,82,52
2019년1분기,골목상권,곰달래로47길,강서구,화곡2동,145973,4075,85,71729,74245,101268,44709,1989,2086,43,42
2019년2분기,골목상권,곰달래로47길,강서구,화곡2동,166577,4075,275,78830,87747,110984,55595,1989,2086,174,101
2019년1분기,골목상권,증산로13길,은평구,증산동,104520,1994,328,56603,47916,67786,36732,1013,981,243,85
2019년2분기,골목상권,증산로13길,은평구,증산동,135933,1994,89,73335,62600,89041,46895,1013,981,48,41
2019년1분기,골목상권,증산로15길,은평구,신사2동,34396,2500,256,19442,14957,25113,9286,1250,1250,138,118
2019년2분기,골목상권,증산로15길,은평구,신사2동,44388,2500,427,25768,18622,30483,13906,1250,1250,323,104
2019년1분기,골목상권,증산로17길,은평구,신사2동,143818,2058,443,72727,71090,101468,42357,984,1074,156,287
2019년2분기,골목상권,증산로17길,은평구,신사2동,179807,2058,164,93568,86241,124278,55532,984,1074,101,63
2019년1분기,골목상권,망원로11길,마포구,망원2동,230568,2171,275,113011,117556,164943,65622,1020,1151,136,139
2019년2분기,골목상권,망원로11길,마포구,망원2동,266799,2171,147,130949,135848,190203,76598,1020,1151,84,63
2019년1분기,골목상권,망원로2길,마포구,망원1동,313664,4381,379,149553,164106,211167,102494,2081,2300,214,165
2019년2분기,골목상권,망원로2길,마포구,망원1동,384848,4381,339,176291,208560,255102,129751,2081,2300,221,118
2019년1분기,골목상권,매봉산로2길,마포구,상암동,314125,2835,1373,176855,137266,254828,59299,1443,1392,865,508
2019년2분기,골목상권,매봉산로2길,마포구,상암동,422943,2835,380,228857,194085,335986,86964,1443,1392,207,173
2019년1분기,골목상권,목동중앙북로16길,양천구,목2동,115237,3495,51,59106,56129,81467,33771,1690,1805,22,29
2019년2분기,골목상권,목동중앙북로16길,양천구,목2동,137033,3495,453,68740,68293,96012,41025,1690,1805,194,259
2019년1분기,골목상권,목동중앙북로8길,양천구,목3동,85283,2135,172,42854,42428,59976,25309,973,1162,64,108
2019년2분기,골목상권,목동중앙북로8길,양천구,목3동,101097,2135,183,49164,51931,70348,30747,973,1162,111,72
2019년1분기,골목상권,목동중앙서로7길,양천구,목4동,201418,3793,188,100031,101386,141858,59567,1848,1945,82,106
2019년2분기,골목상권,목동중앙서로7길,양천구,목4동,236692,3793,121,115314,121378,163786,72903,1848,1945,80,41
2019년1분기,골목상권,우이천로32길,도봉구,쌍문1동,138865,3035,199,69049,69820,96676,42188,1444,1591,97,102
2019년2분기,골목상권,우이천로32길,도봉구,쌍문1동,172849,3035,193,80220,92625,117647,55201,1444,1591,70,123
2019년1분기,골목상권,우이천로4다길,도봉구,창3동,112631,2296,169,55126,57503,79558,33071,1156,1140,67,102
2019년2분기,골목상권,우이천로4다길,도봉구,창3동,118018,2296,101,58242,59775,81674,36344,1156,1140,69,32
2019년1분기,골목상권,해등로16길,도봉구,창5동,64847,2245,183,33990,30859,46038,18812,1084,1161,98,85
2019년2분기,골목상권,해등로16길,도봉구,창5동,81991,2245,98,42341,39653,55935,26058,1084,1161,56,42
2019년1분기,골목상권,증산로21길,은평구,신사1동,267637,5296,209,136750,130891,183208,84442,2567,2729,93,116
2019년2분기,골목상권,증산로21길,은평구,신사1동,310919,5296,270,157428,153491,209185,101737,2567,2729,131,139
2019년1분기,골목상권,증산로5길,은평구,증산동,124544,2741,342,64660,59882,88544,36004,1332,1409,223,119
2019년2분기,골목상권,증산로5길,은평구,증산동,142305,2741,469,75079,67227,98133,44178,1332,1409,262,207
2019년1분기,골목상권,증산로9길,은평구,증산동,37087,2718,174,20373,16713,25694,11394,1329,1389,96,78
2019년2분기,골목상권,증산로9길,은평구,증산동,49676,2718,665,27886,21790,33618,16057,1329,1389,578,87
2019년1분기,골목상권,증산서길,은평구,증산동,90415,820,634,47270,43149,65190,25228,426,394,472,162
2019년2분기,골목상권,증산서길,은평구,증산동,114235,820,264,61213,53024,80904,33329,426,394,170,94
2019년1분기,골목상권,모래내로7길,마포구,성산2동,53674,2027,1080,26634,27041,39435,14241,1005,1022,977,103
2019년2분기,골목상권,모래내로7길,마포구,성산2동,80202,2027,111,40771,39429,56819,23386,1005,1022,83,28
2019년1분기,골목상권,방울내로9안길,마포구,망원2동,440339,5548,345,205313,235025,308975,131355,2681,2867,190,155
2019년2분기,골목상권,방울내로9안길,마포구,망원2동,530149,5548,652,242123,288028,363486,166666,2681,2867,389,263
2019년1분기,골목상권,백범로16길,마포구,대흥동,344543,1705,3061,183037,161505,267791,76751,824,881,2199,862
2019년2분기,골목상권,백범로16길,마포구,대흥동,460432,1705,1781,237113,223320,358547,101885,824,881,1234,547
2019년1분기,골목상권,목동중앙서로8가길,양천구,목4동,97166,1394,347,49708,47458,68130,29038,677,717,178,169
2019년2분기,골목상권,목동중앙서로8가길,양천구,목4동,118608,1394,351,59095,59513,82131,36472,677,717,206,145
2019년1분기,골목상권,신목로2길,양천구,신정2동,168611,2072,160,85188,83422,119462,49146,1020,1052,83,77
2019년2분기,골목상권,신목로2길,양천구,신정2동,179256,2072,339,86623,92634,123578,55679,1020,1052,226,113
2019년1분기,골목상권,신목로5길,양천구,신정2동,212616,2171,263,93022,119594,148256,64363,1073,1098,115,148
2019년2분기,골목상권,신목로5길,양천구,신정2동,243690,2171,578,100084,143601,168492,75193,1073,1098,347,231
2019년1분기,골목상권,공릉로58길,노원구,하계1동,122261,1523,280,68321,53936,90046,32210,759,764,112,168
2019년2분기,골목상권,공릉로58길,노원구,하계1동,138610,1523,118,75783,62828,100670,37937,759,764,55,63
2019년1분기,골목상권,동일로173가길,노원구,공릉1동,477041,3676,1373,250495,226540,344612,132426,1852,1824,860,513
2019년2분기,골목상권,동일로173가길,노원구,공릉1동,555235,3676,1133,285953,269281,395671,159570,1852,1824,839,294
2019년1분기,골목상권,동일로192길,노원구,공릉1동,430312,2866,651,236453,193855,300113,130200,1493,1373,353,298
2019년2분기,골목상권,동일로192길,노원구,공릉1동,471698,2866,390,251643,220053,324386,147315,1493,1373,283,107
2019년1분기,골목상권,진흥로12길,은평구,녹번동,295165,5827,209,142301,152860,210941,84221,2861,2966,80,129
2019년2분기,골목상권,진흥로12길,은평구,녹번동,349256,5827,379,166188,183063,247016,102237,2861,2966,186,193
2019년1분기,골목상권,진흥로1길,은평구,역촌동,476229,4156,284,229249,246981,333608,142629,1998,2158,117,167
2019년2분기,골목상권,진흥로1길,은평구,역촌동,600825,4156,319,282946,317878,420810,180013,1998,2158,179,140
2019년1분기,골목상권,통일로69길,은평구,대조동,63226,1750,57,30967,32257,44465,18762,845,905,14,43
2019년2분기,골목상권,통일로69길,은평구,대조동,73890,1750,112,35985,37906,51583,22307,845,905,43,69
2019년1분기,골목상권,성미산로11길,마포구,성산1동,140605,3658,2453,69119,71485,100699,39905,1734,1924,1874,579
2019년2분기,골목상권,성미산로11길,마포구,성산1동,165606,3658,1167,80587,85016,118092,47510,1734,1924,798,369
2019년1분기,골목상권,성미산로1길,마포구,성산1동,234955,3142,673,119806,115151,169498,65464,1469,1673,433,240
2019년2분기,골목상권,성미산로1길,마포구,성산1동,284782,3142,4503,142264,142522,203481,81295,1469,1673,3329,1174
2019년1분기,골목상권,성미산로32길,마포구,연남동,154909,1174,252,70425,84484,99444,55463,534,640,135,117
2019년2분기,골목상권,성미산로32길,마포구,연남동,165902,1174,180,75383,90518,105696,60208,534,640,106,74
2019년1분기,골목상권,신목로6길,양천구,신정2동,284268,2411,437,142169,142101,204072,80197,1160,1251,219,218
2019년2분기,골목상권,신목로6길,양천구,신정2동,310642,2411,399,150682,159962,217069,93572,1160,1251,277,122
2019년1분기,골목상권,신월로15길,양천구,신월4동,274234,5742,367,146697,127538,196682,77550,2847,2895,136,231
2019년2분기,골목상권,신월로15길,양천구,신월4동,312585,5742,311,162564,150020,220027,92559,2847,2895,152,159
2019년1분기,골목상권,신월로20길,양천구,신월6동,180698,1968,119,101157,79540,133052,47651,995,973,63,56
2019년2분기,골목상권,신월로20길,양천구,신월6동,204836,1968,53,113352,91486,148550,56285,995,973,31,22
2019년1분기,골목상권,동일로242길,노원구,상계1동,163532,2506,1271,84691,78842,110982,52548,1237,1269,885,386
2019년2분기,골목상권,동일로242길,노원구,상계1동,193198,2506,557,96900,96301,128838,64359,1237,1269,352,205
2019년1분기,골목상권,상계로12길,노원구,상계2동,222203,3570,271,107973,114232,155841,66370,1774,1796,145,126
2019년2분기,골목상권,상계로12길,노원구,상계2동,257318,3570,143,119861,137460,177408,79910,1774,1796,88,55
2019년1분기,골목상권,상계로1길,노원구,상계2동,314044,1199,199,166279,147764,218558,95483,608,591,64,135
2019년2분기,골목상권,상계로1길,노원구,상계2동,356133,1199,280,189045,167088,242190,113942,608,591,189,91
2019년1분기,골목상권,통일로78길,은평구,불광2동,115553,4505,92,56090,59463,79973,35584,2164,2341,40,52
2019년2분기,골목상권,통일로78길,은평구,불광2동,113935,4505,154,54523,59413,78225,35706,2164,2341,49,105
2019년1분기,골목상권,통일로87길,은평구,갈현1동,277862,1816,310,145870,131995,192512,85351,873,943,169,141
2019년2분기,골목상권,통일로87길,은평구,갈현1동,333340,1816,308,169181,164161,226426,106914,873,943,158,150
2019년1분기,골목상권,통일로92길,은평구,불광2동,227869,5780,82,112695,115171,158052,69811,2880,2900,28,54
2019년2분기,골목상권,통일로92길,은평구,불광2동,276572,5780,184,136936,139635,187845,88721,2880,2900,79,105
2019년1분기,골목상권,성산로4길,마포구,성산1동,191993,3416,1594,92463,99528,137865,54130,1678,1738,851,743
2019년2분기,골목상권,성산로4길,마포구,성산1동,241295,3416,1260,115203,126091,173098,68194,1678,1738,726,534
2019년1분기,골목상권,성지3길,마포구,합정동,183513,1008,485,96271,87241,129101,54410,463,545,273,212
2019년2분기,골목상권,성지3길,마포구,합정동,243791,1008,323,124121,119668,170681,73106,463,545,224,99
2019년1분기,골목상권,숭문8길,마포구,염리동,78966,790,75,41555,37413,58179,20791,376,414,35,40
2019년2분기,골목상권,숭문8길,마포구,염리동,87108,790,127,45052,42055,63399,23710,376,414,72,55
2019년1분기,골목상권,오목로23길,양천구,신정4동,216325,4491,296,112770,103555,156669,59659,2264,2227,147,149
2019년2분기,골목상권,오목로23길,양천구,신정4동,247869,4491,492,127536,120332,175911,71957,2264,2227,171,321
2019년1분기,골목상권,오목로30길,양천구,신정4동,167153,3628,344,87028,80125,118941,48211,1785,1843,165,179
2019년2분기,골목상권,오목로30길,양천구,신정4동,182256,3628,230,95155,87101,127604,54658,1785,1843,130,100
2019년1분기,골목상권,오목로3길,양천구,신월4동,156963,3610,381,82393,74574,111159,45809,1805,1805,293,88
2019년2분기,골목상권,오목로3길,양천구,신월4동,185288,3610,208,95694,89594,128014,57276,1805,1805,145,63
2019년1분기,골목상권,상계로9가길,노원구,상계2동,462340,2597,276,227953,234390,328591,133750,1341,1256,129,147
2019년2분기,골목상권,상계로9가길,노원구,상계2동,550446,2597,288,262652,287793,389045,161400,1341,1256,106,182
2019년1분기,골목상권,석계로1길,노원구,월계1동,294812,2084,253,158943,135866,211351,83465,1078,1006,92,161
2019년2분기,골목상권,석계로1길,노원구,월계1동,231257,2084,619,124960,106297,162235,69020,1078,1006,268,351
2019년1분기,골목상권,한글비석로22길,노원구,중계4동,462667,1815,397,251292,211375,322985,139683,926,889,152,245
2019년2분기,골목상권,한글비석로22길,노원구,중계4동,547402,1815,156,290490,256911,376977,170421,926,889,73,83
2019년1분기,골목상권,가재울로6길,서대문구,남가좌2동,296102,2757,246,152675,143427,210765,85341,1351,1406,121,125
2019년2분기,골목상권,가재울로6길,서대문구,남가좌2동,336848,2757,135,169747,167101,237725,99126,1351,1406,78,57
2019년1분기,골목상권,독립문로8길,서대문구,천연동,315486,4172,326,162084,153403,228505,86989,1958,2214,131,195
2019년2분기,골목상권,독립문로8길,서대문구,천연동,384341,4172,734,191476,192861,273588,110762,1958,2214,453,281
2019년1분기,골목상권,명지대길,서대문구,남가좌2동,290223,2429,428,151625,138596,216316,73909,1168,1261,297,131
2019년2분기,골목상권,명지대길,서대문구,남가좌2동,365352,2429,312,185921,179429,278198,87158,1168,1261,209,103
2019년1분기,골목상권,숭문길,마포구,염리동,386666,2779,3813,205859,180810,306573,80087,1377,1402,2815,998
2019년2분기,골목상권,숭문길,마포구,염리동,508090,2779,2192,263489,244599,403814,104277,1377,1402,1610,582
2019년1분기,골목상권,신촌로12길,마포구,서교동,295071,1917,573,137130,157939,199181,95887,931,986,316,257
2019년2분기,골목상권,신촌로12길,마포구,서교동,328566,1917,276,151683,176885,218125,110438,931,986,150,126
2019년1분기,골목상권,신촌로28가길,마포구,아현동,203956,190,34,93260,110697,142880,61075,100,90,8,26
2019년2분기,골목상권,신촌로28가길,마포구,아현동,227711,190,91,104318,123392,157674,70037,100,90,27,64
2019년1분기,골목상권,오목로5길,양천구,신월4동,105311,4021,226,52079,53231,73784,31525,1969,2052,77,149
2019년2분기,골목상권,오목로5길,양천구,신월4동,116452,4021,112,59171,57283,79592,36858,1969,2052,76,36
2019년1분기,골목상권,은행정로5길,양천구,신정1동,105376,793,349,53320,52055,75804,29572,430,363,160,189
2019년2분기,골목상권,은행정로5길,양천구,신정1동,120761,793,171,59839,60922,86181,34579,430,363,62,109
2019년1분기,골목상권,은행정로7길,양천구,신정4동,249933,3339,568,128689,121246,184197,65731,1641,1698,206,362
2019년2분기,골목상권,은행정로7길,양천구,신정4동,283472,3339,448,145349,138125,204699,78771,1641,1698,180,268
2019년1분기,골목상권,한글비석로24길,노원구,상계5동,269340,2465,291,143478,125859,185559,83780,1255,1210,117,174
2019년2분기,골목상권,한글비석로24길,노원구,상계5동,306394,2465,197,159514,146881,207899,98494,1255,1210,76,121
2019년1분기,골목상권,한글비석로44길,노원구,상계5동,255541,3932,338,128229,127316,178335,77209,1969,1963,149,189
2019년2분기,골목상권,한글비석로44길,노원구,상계5동,301123,3932,235,147981,153141,206476,94650,1969,1963,91,144
2019년1분기,골목상권,가좌로7길,은평구,응암3동,327910,3671,269,167549,160363,232313,95600,1824,1847,124,145
2019년2분기,골목상권,가좌로7길,은평구,응암3동,407012,3671,429,202984,204025,284800,122211,1824,1847,223,206
2019년1분기,골목상권,모래내로15길,서대문구,남가좌1동,201737,10755,351,97993,103743,144332,57404,5182,5573,145,206
2019년2분기,골목상권,모래내로15길,서대문구,남가좌1동,233917,10755,137,113370,120545,165698,68219,5182,5573,31,106
2019년1분기,골목상권,북아현로4길,서대문구,북아현동,948599,3522,422,520298,428300,807771,140827,1692,1830,85,337
2019년2분기,골목상권,북아현로4길,서대문구,북아현동,1429914,3522,212,762114,667800,1147099,282807,1692,1830,96,116
2019년1분기,골목상권,세검정로1길,서대문구,홍은1동,144710,1162,294,68297,76414,101353,43359,558,604,85,209
2019년2분기,골목상권,세검정로1길,서대문구,홍은1동,144079,1162,179,66371,77708,98229,45852,558,604,40,139
2019년1분기,골목상권,신촌로30길,마포구,아현동,134635,515,57,63934,70703,94949,39691,256,259,28,29
2019년2분기,골목상권,신촌로30길,마포구,아현동,157676,515,91,73575,84099,111279,46394,256,259,49,42
2019년1분기,골목상권,양화로11길,마포구,서교동,179531,759,2503,87531,92001,130234,49299,327,432,936,1567
2019년2분기,골목상권,양화로11길,마포구,서교동,211878,759,2245,102968,108911,151549,60331,327,432,883,1362
2019년1분기,골목상권,양화로1길,마포구,합정동,312115,2663,768,156689,155425,225250,86866,1208,1455,408,360
2019년2분기,골목상권,양화로1길,마포구,합정동,357441,2663,676,174201,183244,256879,100560,1208,1455,339,337
2019년1분기,골목상권,중앙로25길,양천구,신정3동,136492,1915,185,78379,58111,99130,37362,1019,896,70,115
2019년2분기,골목상권,중앙로25길,양천구,신정3동,161773,1915,118,89551,72221,115152,46623,1019,896,79,39
2019년1분기,골목상권,중앙로32길,양천구,신정1동,246074,1107,614,126769,119306,180372,65704,543,564,278,336
2019년2분기,골목상권,중앙로32길,양천구,신정1동,279978,1107,161,140812,139166,203554,76426,543,564,102,59
2019년1분기,골목상권,중앙로36길,양천구,신정1동,103295,914,272,51869,51425,74543,28755,452,462,118,154
2019년2분기,골목상권,중앙로36길,양천구,신정1동,119362,914,74,58760,60600,85190,34176,452,462,37,37
2019년1분기,골목상권,갈현로1길,은평구,신사1동,147531,2845,133,77652,69878,102145,45384,1379,1466,63,70
2019년2분기,골목상권,갈현로1길,은평구,신사1동,160459,2845,93,81789,78670,108007,52453,1379,1466,44,49
2019년1분기,골목상권,갈현로33길,은평구,갈현2동,219325,3678,188,100333,118988,158701,60624,1769,1909,77,111
2019년2분기,골목상권,갈현로33길,은평구,갈현2동,283758,3678,272,131318,152442,206283,77475,1769,1909,159,113
2019년1분기,골목상권,갈현로41길,은평구,갈현1동,61647,3187,82,29428,32220,39828,21822,1564,1623,21,61
2019년2분기,골목상권,갈현로41길,은평구,갈현1동,91992,3187,155,43069,48922,59067,32922,1564,1623,59,96
2019년1분기,골목상권,세무서2길,서대문구,홍제2동,114241,1455,446,47583,66658,79036,35203,706,749,204,242
2019년2분기,골목상권,세무서2길,서대문구,홍제2동,134797,1455,185,62779,72018,93640,41158,706,749,92,93
2019년1분기,골목상권,세무서길,서대문구,홍제3동,256910,2406,294,119367,137543,181188,75725,1168,1238,90,204
2019년2분기,골목상권,세무서길,서대문구,홍제3동,283561,2406,449,137595,145967,200101,83468,1168,1238,174,275
2019년1분기,골목상권,수색로8길,서대문구,북가좌1동,212589,3660,342,101626,110965,148312,64282,1779,1881,235,107
2019년2분기,골목상권,수색로8길,서대문구,북가좌1동,245828,3660,2502,116713,129120,168057,77769,1779,1881,2197,305
2019년1분기,골목상권,양화진길,마포구,합정동,142995,1294,1079,71998,70998,98424,44573,593,701,647,432
2019년2분기,골목상권,양화진길,마포구,합정동,184575,1294,735,88841,95736,124487,60091,593,701,445,290
2019년1분기,골목상권,와우산로29가길,마포구,서교동,185247,502,1165,72543,112707,124520,60725,229,273,743,422
2019년2분기,골목상권,와우산로29가길,마포구,서교동,214090,502,884,85261,128830,142034,72057,229,273,601,283
2019년1분기,골목상권,와우산로29길,마포구,서교동,177185,786,375,76454,100731,115610,61574,367,419,221,154
2019년2분기,골목상권,와우산로29길,마포구,서교동,214439,786,132,93238,121200,136678,77762,367,419,75,57
2019년1분기,골목상권,와우산로3길,마포구,서강동,137092,1757,328,69854,67238,95594,41498,828,929,180,148
2019년2분기,골목상권,와우산로3길,마포구,서강동,166888,1757,269,82086,84799,115802,51088,828,929,178,91
2019년1분기,골목상권,중앙로45길,양천구,신정3동,156390,1960,177,80929,75463,109678,46715,953,1007,67,110
2019년2분기,골목상권,중앙로45길,양천구,신정3동,186040,1960,1410,95319,90721,130247,55793,953,1007,1336,74
2019년1분기,골목상권,중앙로47길,양천구,신정3동,170191,1901,37,91058,79132,119017,51165,982,919,9,28
2019년2분기,골목상권,중앙로47길,양천구,신정3동,206464,1901,79,108658,97807,143198,63272,982,919,39,40
2019년1분기,골목상권,중앙로51길,양천구,신월2동,287922,4174,165,136847,151073,195079,92844,2059,2115,67,98
2019년2분기,골목상권,중앙로51길,양천구,신월2동,172683,4174,474,82750,89935,110024,62652,2059,2115,315,159
2019년1분기,골목상권,갈현로7길,은평구,역촌동,350382,2471,176,165373,185008,252264,98115,1196,1275,82,94
2019년2분기,골목상권,갈현로7길,은평구,역촌동,401275,2471,285,188898,212374,284867,116406,1196,1275,154,131
2019년1분기,골목상권,불광천길,은평구,응암3동,260246,5214,298,131601,128647,179995,80257,2531,2683,110,188
2019년2분기,골목상권,불광천길,은평구,응암3동,307871,5214,197,155976,151890,210000,97872,2531,2683,99,98
2019년1분기,골목상권,서오릉로21길,은평구,구산동,201671,3994,81,93782,107891,135627,66040,1908,2086,15,66
2019년2분기,골목상권,서오릉로21길,은평구,구산동,228406,3994,130,104279,124124,151850,76555,1908,2086,40,90
2019년1분기,골목상권,서오릉로8길,은평구,대조동,49050,2650,161,26026,23027,33928,15122,1243,1407,72,89
2019년2분기,골목상권,서오릉로8길,은평구,대조동,61691,2650,152,30280,31411,42862,18827,1243,1407,98,54
2019년1분기,골목상권,신촌로37길,서대문구,북아현동,494341,795,87,253384,240957,389620,104722,449,346,43,44
2019년2분기,골목상권,신촌로37길,서대문구,북아현동,593181,795,36,295875,297302,466216,126961,449,346,16,20
2019년1분기,골목상권,연희로10길,서대문구,연희동,164515,3359,175,85159,79352,118799,45713,1842,1517,77,98
2019년2분기,골목상권,연희로10길,서대문구,연희동,167665,3359,3486,85151,82517,121078,46596,1842,1517,3183,303
2019년1분기,골목상권,응암로1길,서대문구,북가좌2동,256607,3845,681,130174,126434,179122,77485,1875,1970,401,280
2019년2분기,골목상권,응암로1길,서대문구,북가좌2동,323467,3845,652,160247,163217,222198,101267,1875,1970,405,247
2019년1분기,골목상권,월드컵로10길,마포구,서교동,258095,2393,1785,122397,135699,193042,65052,1111,1282,951,834
2019년2분기,골목상권,월드컵로10길,마포구,서교동,322954,2393,1245,153597,169357,240643,82308,1111,1282,730,515
2019년1분기,골목상권,월드컵로11길,마포구,망원1동,226237,2423,515,103571,122667,159323,66914,1122,1301,178,337
2019년2분기,골목상권,월드컵로11길,마포구,망원1동,277046,2423,408,128620,148427,193852,83196,1122,1301,138,270
2019년1분기,골목상권,월드컵로16길,마포구,서교동,227478,2463,2793,102672,124805,169295,58184,1144,1319,1491,1302
2019년2분기,골목상권,월드컵로16길,마포구,서교동,288174,2463,1290,131768,156407,211554,76624,1144,1319,882,408
2019년1분기,골목상권,중앙로55길,양천구,신월2동,233731,3733,167,112805,120928,160435,73301,1841,1892,77,90
2019년2분기,골목상권,중앙로55길,양천구,신월2동,143707,3733,358,69958,73752,94913,48798,1841,1892,218,140
2019년1분기,골목상권,지양로7길,양천구,신월7동,105996,3276,215,55836,50158,75622,30377,1616,1660,82,133
2019년2분기,골목상권,지양로7길,양천구,신월7동,127827,3276,221,66799,61031,89007,38815,1616,1660,110,111
2019년1분기,골목상권,화곡로3길,양천구,신월5동,71288,3208,246,37607,33683,55561,15728,1599,1609,104,142
2019년2분기,골목상권,화곡로3길,양천구,신월5동,96704,3208,264,50090,46619,71822,24884,1599,1609,141,123
2019년1분기,골목상권,수색로18길,은평구,수색동,63038,1060,190,43363,19677,46622,16421,528,532,110,80
2019년2분기,골목상권,수색로18길,은평구,수색동,84838,1060,146,53849,30988,62672,22166,528,532,100,46
2019년1분기,골목상권,역말로9길,은평구,대조동,163481,5545,143,73373,90106,117120,46362,2660,2885,75,68
2019년2분기,골목상권,역말로9길,은평구,대조동,178604,5545,195,76665,101937,127413,51192,2660,2885,101,94
2019년1분기,골목상권,연서로11길,은평구,구산동,233929,3920,158,108521,125407,167501,66434,1858,2062,80,78
2019년2분기,골목상권,연서로11길,은평구,구산동,235466,3920,614,101008,134455,167135,68334,1858,2062,256,358
2019년1분기,골목상권,증가로10길,서대문구,남가좌2동,311223,3875,255,156872,154351,242871,68350,1875,2000,129,126
2019년2분기,골목상권,증가로10길,서대문구,남가좌2동,501894,3875,136,242275,259620,404137,97760,1875,2000,78,58
2019년1분기,골목상권,증가로20가길,서대문구,북가좌2동,226984,3592,353,110861,116124,170938,56046,1793,1799,104,249
2019년2분기,골목상권,증가로20가길,서대문구,북가좌2동,266174,3592,280,126927,139248,203816,62361,1793,1799,111,169
2019년1분기,골목상권,증가로23나길,서대문구,북가좌2동,452050,5204,405,224875,227170,319412,132637,2497,2707,186,219
2019년2분기,골목상권,증가로23나길,서대문구,북가좌2동,500185,5204,869,239143,261039,347723,152460,2497,2707,405,464
2019년1분기,골목상권,월드컵로19길,마포구,망원1동,271267,1615,694,122679,148590,186200,85066,748,867,318,376
2019년2분기,골목상권,월드컵로19길,마포구,망원1동,328134,1615,270,147561,180574,225109,103032,748,867,185,85
2019년1분기,골목상권,월드컵로25길,마포구,망원2동,233885,3070,304,115354,118532,162697,71188,1483,1587,131,173
2019년2분기,골목상권,월드컵로25길,마포구,망원2동,279554,3070,307,129378,150179,190589,88972,1483,1587,119,188
2019년1분기,골목상권,월드컵로36길,마포구,성산2동,174603,3832,577,84718,89886,124231,50365,1709,2123,318,259
2019년2분기,골목상권,월드컵로36길,마포구,성산2동,215794,3832,503,102449,113342,150176,65615,1709,2123,334,169
2019년1분기,골목상권,화곡로4길,양천구,신월5동,74747,1593,417,41665,33083,55272,19475,793,800,145,272
2019년2분기,골목상권,화곡로4길,양천구,신월5동,94403,1593,248,51007,43399,68571,25835,793,800,180,68
2019년1분기,골목상권,가로공원로76가길,강서구,화곡1동,136337,3221,132,64430,71907,95685,40653,1551,1670,66,66
2019년2분기,골목상권,가로공원로76가길,강서구,화곡1동,150219,3221,212,67943,82277,103902,46320,1551,1670,117,95
2019년1분기,골목상권,가로공원로80길,강서구,화곡1동,78131,2881,265,39021,39109,55181,22948,1451,1430,109,156
2019년2분기,골목상권,가로공원로80길,강서구,화곡1동,95953,2881,382,46797,49159,66640,29312,1451,1430,190,192
2019년1분기,골목상권,연서로13길,은평구,구산동,86523,3952,197,37347,49177,64830,21695,1860,2092,42,155
2019년2분기,골목상권,연서로13길,은평구,구산동,87039,3952,388,36457,50581,63326,23710,1860,2092,274,114
2019년1분기,골목상권,연서로16길,은평구,역촌동,529700,4663,315,246285,283415,387831,141870,2203,2460,160,155
2019년2분기,골목상권,연서로16길,은평구,역촌동,652582,4663,316,292406,360178,470878,181707,2203,2460,187,129
2019년1분기,골목상권,연서로17길,은평구,갈현2동,213956,2252,587,99758,114196,151170,62786,1068,1184,231,356
2019년2분기,골목상권,연서로17길,은평구,갈현2동,240984,2252,623,110466,130518,167887,73097,1068,1184,157,466
2019년1분기,골목상권,증가로6길,서대문구,홍은2동,169244,3064,359,80881,88364,117154,52091,1515,1549,258,101
2019년2분기,골목상권,증가로6길,서대문구,홍은2동,206981,3064,375,101238,105750,141560,65424,1515,1549,305,70
2019년1분기,골목상권,충정로4길,서대문구,충현동,345220,499,5040,187065,158158,285389,59830,248,251,3125,1915
2019년2분기,골목상권,충정로4길,서대문구,충현동,417049,499,2596,219608,197440,343307,73745,248,251,1459,1137
2019년1분기,골목상권,충정로6길,서대문구,충현동,177918,688,4645,105650,72267,152948,24971,362,326,2804,1841
2019년2분기,골목상권,충정로6길,서대문구,충현동,192557,688,3745,112969,79588,164307,28250,362,326,2262,1483
2019년1분기,발달상권,서울 강남구 대치역_1,강남구,대치1동,81731,519,319,36604,45128,62870,18862,260,259,115,204
2019년2분기,발달상권,서울 강남구 대치역_1,강남구,대치1동,90824,519,99,39574,51250,68593,22230,260,259,31,68
2019년1분기,발달상권,서울 강남구 대치역_2,강남구,대치1동,198642,642,1138,86141,112501,150983,47658,306,336,562,576
2019년2분기,발달상권,서울 강남구 대치역_2,강남구,대치1동,183039,642,981,77843,105197,137152,45888,306,336,565,416
2019년1분기,발달상권,서울 서초구 서초역,서초구,서초3동,131406,55,3711,82104,49302,108095,23310,31,24,1932,1779
2019년2분기,발달상권,서울 서초구 서초역,서초구,서초3동,161196,55,1791,97696,63502,128658,32541,31,24,903,888
2019년1분기,발달상권,서울 강남구 학동역_2,강남구,논현2동,108575,105,3399,62280,46295,89256,19322,49,56,2080,1319
2019년2분기,발달상권,서울 강남구 학동역_2,강남구,논현2동,123569,105,2446,70340,53231,99346,24223,49,56,1605,841
2019년1분기,발달상권,방이동 먹자골목,송파구,방이2동,881008,1418,5226,495540,385466,633126,247882,759,659,3150,2076
2019년2분기,발달상권,방이동 먹자골목,송파구,방이2동,1059585,1418,7253,587349,472237,742231,317353,759,659,4766,2487
2019년1분기,발달상권,학동역,강남구,논현1동,122276,532,2812,69123,53153,101561,20714,220,312,1340,1472
2019년2분기,발달상권,학동역,강남구,논현1동,142012,532,1016,79548,62464,116515,25499,220,312,607,409
2019년1분기,발달상권,서울 강동구 천호역,송파구,풍납1동,160315,279,625,65220,95096,110725,49591,133,146,243,382
2019년2분기,발달상권,서울 강동구 천호역,송파구,풍납1동,210893,279,327,80528,130367,143820,67072,133,146,139,188
2019년1분기,발달상권,서울 광진구 구의역,광진구,구의1동,369038,1871,1490,207078,161960,261003,108034,844,1027,866,624
2019년2분기,발달상권,서울 광진구 구의역,광진구,구의1동,443406,1871,914,245033,198372,311477,131932,844,1027,588,326
2019년1분기,발달상권,건대입구역,광진구,자양3동,87473,530,865,37092,50381,59507,27966,224,306,447,418
2019년2분기,발달상권,건대입구역,광진구,자양3동,104834,530,362,44335,60499,71513,33325,224,306,212,150
2019년1분기,골목상권,천호대로170길,강동구,성내2동,337140,4152,798,168289,168851,237617,99524,2078,2074,504,294
2019년2분기,골목상권,천호대로170길,강동구,성내2동,423071,4152,328,211749,211321,295780,127293,2078,2074,202,126
2019년1분기,골목상권,천호대로187길,강동구,길동,273375,2777,595,139315,134059,196009,77371,1375,1402,309,286
2019년2분기,골목상권,천호대로187길,강동구,길동,325729,2777,348,162518,163212,230967,94760,1375,1402,195,153
2019년1분기,골목상권,천호대로197길,강동구,길동,212943,4523,239,106476,106463,146119,66822,2227,2296,117,122
2019년2분기,골목상권,천호대로197길,강동구,길동,309262,4523,504,149761,159498,210320,98940,2227,2296,261,243
2019년1분기,발달상권,서울 송파구 가락시장역,송파구,가락본동,338438,570,5688,198703,139734,266625,71812,301,269,3485,2203
2019년2분기,발달상권,서울 송파구 가락시장역,송파구,가락본동,410596,570,4251,238913,171683,321998,88596,301,269,2667,1584
2019년1분기,발달상권,교대역_2,서초구,서초1동,921325,1758,4587,537723,383605,733220,188107,850,908,2523,2064
2019년2분기,발달상권,교대역_2,서초구,서초1동,1107757,1758,2851,636752,471007,880280,227475,850,908,1597,1254
2019년1분기,발달상권,역삼역_1,강남구,역삼1동,341173,2795,4310,193132,148042,266025,75146,1349,1446,2476,1834
2019년2분기,발달상권,역삼역_1,강남구,역삼1동,360861,2795,4438,199020,161838,280735,80122,1349,1446,2701,1737
2019년1분기,발달상권,강남구 논현역_4,서초구,잠원동,941645,1932,9949,529400,412247,743680,197963,971,961,5407,4542
2019년2분기,발달상권,강남구 논현역_4,서초구,잠원동,1067921,1932,6134,589704,478219,864300,203621,971,961,3682,2452
2019년1분기,발달상권,잠실역,송파구,잠실6동,360389,1787,40450,178954,181435,296221,64164,838,949,17880,22570
2019년2분기,발달상권,잠실역,송파구,잠실6동,458041,1787,45953,225196,232846,374808,83237,838,949,24023,21930
2019년1분기,발달상권,서울 강남구 강남구청역_1,강남구,논현2동,477672,565,4603,248210,229465,379161,98506,285,280,2720,1883
2019년2분기,발달상권,서울 강남구 강남구청역_1,강남구,논현2동,571344,565,3755,292513,278830,448313,123034,285,280,2581,1174
2019년1분기,발달상권,서울 광진구 건대입구역_1,광진구,자양4동,448610,1027,581,215192,233418,311046,137565,491,536,233,348
2019년2분기,발달상권,서울 광진구 건대입구역_1,광진구,자양4동,564981,1027,154,261707,303274,387026,177955,491,536,67,87
2019년1분기,발달상권,서울 강동구 천호역_2,강동구,천호2동,1048244,4607,3905,503901,544340,713241,335003,2227,2380,1728,2177
2019년2분기,발달상권,서울 강동구 천호역_2,강동구,천호2동,1408414,4607,2198,660098,748314,949834,458574,2227,2380,1018,1180
2019년1분기,발달상권,서울 마포구 마포역_1,마포구,도화동,908381,844,4891,503380,405001,728880,179504,445,399,3266,1625
2019년2분기,발달상권,서울 마포구 마포역_1,마포구,도화동,1033974,844,3431,554828,479141,830407,203566,445,399,2457,974
2019년1분기,골목상권,천호대로219길,강동구,상일동,40429,2208,823,27731,12697,33751,6680,1105,1103,262,561
2019년2분기,골목상권,천호대로219길,강동구,상일동,55873,2208,462,37566,18307,45705,10165,1105,1103,305,157
2019년1분기,골목상권,천호옛14길,강동구,성내2동,332500,2323,252,166394,166106,234885,97619,1114,1209,151,101
2019년2분기,골목상권,천호옛14길,강동구,성내2동,390072,2323,149,189332,200742,273770,116300,1114,1209,95,54
2019년1분기,골목상권,천호옛길,강동구,성내2동,658713,4032,728,327192,331520,458077,200639,2056,1976,463,265
2019년2분기,골목상권,천호옛길,강동구,성내2동,738256,4032,543,369072,369178,509172,229086,2056,1976,378,165
2019년1분기,발달상권,교대역_3,서초구,서초3동,279275,24,3023,161909,117364,232101,47172,11,13,1690,1333
2019년2분기,발달상권,교대역_3,서초구,서초3동,342322,24,1262,191381,150940,283632,58693,11,13,780,482
2019년1분기,발달상권,방배동카페골목,서초구,방배본동,112713,2604,523,57426,55289,81360,31361,1234,1370,234,289
2019년2분기,발달상권,방배동카페골목,서초구,방배본동,140791,2604,229,70033,70761,99744,41051,1234,1370,97,132
2019년1분기,발달상권,서울 강남구 강남역_1,서초구,서초2동,1309928,3012,30628,689746,620182,1098199,211734,1440,1572,17117,13511
2019년2분기,발달상권,서울 강남구 강남역_1,서초구,서초2동,1470106,3012,26031,769492,700617,1228713,241397,1440,1572,15075,10956
2019년1분기,발달상권,서울 강남구 학동역_3,강남구,논현2동,132570,113,5416,73984,58589,107934,24637,64,49,2694,2722
2019년2분기,발달상권,서울 강남구 학동역_3,강남구,논현2동,161946,113,3886,88760,73182,131624,30325,64,49,1975,1911
2019년1분기,발달상권,서울 동작구 노량진1동_1,동작구,노량진1동,71887,12,235,40880,31008,53528,18360,8,4,142,93
2019년2분기,발달상권,서울 동작구 노량진1동_1,동작구,노량진1동,83067,12,98,46414,36652,61684,21382,8,4,59,39
2019년1분기,발달상권,강남구 신사역_1,서초구,잠원동,144840,766,1587,79892,64949,110837,34002,411,355,819,768
2019년2분기,발달상권,강남구 신사역_1,서초구,잠원동,174415,766,1123,95000,79416,132194,42217,411,355,644,479
2019년1분기,발달상권,서울 강남구 강남구청역_2,강남구,논현2동,338284,757,5291,176470,161811,277941,60343,377,380,2804,2487
2019년2분기,발달상권,서울 강남구 강남구청역_2,강남구,논현2동,509765,757,2489,257308,252456,414741,95024,377,380,1347,1142
2019년1분기,발달상권,서울 광진구 건대입구역_2,광진구,화양동,2292113,2009,1569,1169750,1122367,1530426,761685,905,1104,741,828
2019년2분기,발달상권,서울 광진구 건대입구역_2,광진구,화양동,2824505,2009,551,1397640,1426864,1861896,962605,905,1104,301,250
2019년1분기,발달상권,서울 마포구 마포역_2,마포구,용강동,1081124,3534,14367,588550,492572,870536,210591,1619,1915,8130,6237
2019년2분기,발달상권,서울 마포구 마포역_2,마포구,용강동,1256087,3534,13137,665352,590734,1002544,253542,1619,1915,8053,5084
2019년1분기,발달상권,서울 마포구 공덕역_1,마포구,공덕동,244553,599,8182,125828,118725,186997,57557,279,320,4971,3211
2019년2분기,발달상권,서울 마포구 공덕역_1,마포구,공덕동,192148,599,5172,100461,91689,149884,42263,279,320,3743,1429
2019년1분기,골목상권,풍성로37가길,강동구,성내2동,163042,3088,271,78375,84670,117840,45204,1526,1562,61,210
2019년2분기,골목상권,풍성로37가길,강동구,성내2동,180328,3088,231,85709,94618,126464,53853,1526,1562,73,158
2019년1분기,발달상권,서울 금천구 시흥1동_4,금천구,시흥1동,322950,1566,1128,149590,173363,223931,99022,815,751,425,703
2019년2분기,발달상권,서울 금천구 시흥1동_4,금천구,시흥1동,448855,1566,590,219119,229735,339053,109804,815,751,216,374
2019년1분기,발달상권,양재 화물트럭터미널앞_1,서초구,양재2동,19141,2,2535,9669,9472,13576,5565,2,0,2089,446
2019년2분기,발달상권,양재 화물트럭터미널앞_1,서초구,양재2동,21220,2,1955,11177,10042,15776,5444,2,0,1643,312
2019년1분기,발달상권,양재 화물트럭터미널앞_2,서초구,양재2동,22877,1656,2333,11796,11080,16289,6587,813,843,1733,600
2019년2분기,발달상권,양재 화물트럭터미널앞_2,서초구,양재2동,26855,1656,1137,14183,12673,18672,8183,813,843,848,289
2019년1분기,발달상권,교대역_4,서초구,서초4동,407463,1002,6657,226462,180998,331849,75608,499,503,3414,3243
2019년2분기,발달상권,교대역_4,서초구,서초4동,492547,1002,6895,270906,221644,394360,98189,499,503,4614,2281
2019년1분기,발달상권,대림역_1,구로구,구로4동,35888,1754,565,19649,16240,26986,8903,788,966,290,275
2019년2분기,발달상권,대림역_1,구로구,구로4동,43992,1754,278,23190,20802,32900,11091,788,966,163,115
2019년1분기,발달상권,은마아파트입구사거리_1,강남구,대치1동,75002,188,480,38090,36911,47152,27849,97,91,147,333
2019년2분기,발달상권,은마아파트입구사거리_1,강남구,대치1동,78386,188,347,38932,39454,47681,30704,97,91,182,165
2019년1분기,발달상권,영등포역_1,영등포구,영등포동,81217,323,451,46793,34424,50333,30885,178,145,259,192
2019년2분기,발달상권,영등포역_1,영등포구,영등포동,98784,323,110,56619,42165,60214,38571,178,145,48,62
2019년1분기,발달상권,강남구 신사역_2,강남구,논현1동,664698,1041,10284,330214,334489,505352,159341,451,590,4700,5584
2019년2분기,발달상권,강남구 신사역_2,강남구,논현1동,783197,1041,9468,392617,390584,600282,182919,451,590,3993,5475
2019년1분기,발달상권,문래동 주민센터,영등포구,문래동,81965,1488,16718,47436,34530,64259,17705,735,753,8110,8608
2019년2분기,발달상권,문래동 주민센터,영등포구,문래동,97573,1488,6909,55341,42233,75233,22338,735,753,4050,2859
2019년1분기,발달상권,서울 강동구 고덕역,강동구,명일2동,446684,2715,1397,241390,205293,327384,119299,1358,1357,634,763
2019년2분기,발달상권,서울 강동구 고덕역,강동구,명일2동,574054,2715,1023,296101,277954,409345,164710,1358,1357,653,370
2019년1분기,발달상권,서울 중구 약수역_1,중구,약수동,36651,10,41,18590,18061,28201,8449,6,4,14,27
2019년2분기,발달상권,서울 중구 약수역_1,중구,약수동,43993,10,13,22247,21746,33658,10334,6,4,3,10
2019년1분기,발달상권,서울 중구 약수역_2,중구,다산동,91081,53,515,46667,44413,72353,18725,28,25,215,300
2019년2분기,발달상권,서울 중구 약수역_2,중구,다산동,114098,53,206,59907,54191,90557,23542,28,25,95,111
2019년1분기,발달상권,서울 금천구 독산1동_1,금천구,독산1동,221549,1199,4841,119308,102241,164864,56687,658,541,2882,1959
2019년2분기,발달상권,서울 금천구 독산1동_1,금천구,독산1동,251070,1199,991,130862,120207,185676,65392,658,541,624,367
2019년1분기,발달상권,서울 관악구 대학동_1,관악구,대학동,426407,1689,932,259680,166729,299330,127078,1025,664,703,229
2019년2분기,발달상권,서울 관악구 대학동_1,관악구,대학동,486385,1689,348,291283,195103,339102,147280,1025,664,230,118
2019년1분기,발달상권,서울 강남구 강남역,강남구,역삼1동,1595243,2548,33083,856798,738446,1277795,317454,1191,1357,12913,20170
2019년2분기,발달상권,서울 강남구 강남역,강남구,역삼1동,1788210,2548,38675,944948,843264,1419175,369036,1191,1357,18386,20289
2019년1분기,발달상권,오류동역,구로구,오류1동,473703,3851,1862,250338,223366,336531,137176,1843,2008,961,901
2019년2분기,발달상권,오류동역,구로구,오류1동,580099,3851,1857,299460,280641,411126,168975,1843,2008,1329,528
2019년1분기,발달상권,은마아파트입구사거리_2,강남구,대치2동,50353,17,207,25961,24392,34109,16244,9,8,99,108
2019년2분기,발달상권,은마아파트입구사거리_2,강남구,대치2동,54492,17,5766,27427,27065,35859,18633,9,8,3271,2495
2019년1분기,발달상권,은마아파트입구사거리_3,강남구,대치4동,75813,303,292,38737,37077,48561,27254,152,151,138,154
2019년2분기,발달상권,은마아파트입구사거리_3,강남구,대치4동,78877,303,92,39380,39497,48937,29940,152,151,37,55
2019년1분기,발달상권,영등포역_2,영등포구,영등포동,1147889,789,969,654614,493276,734829,413058,577,212,512,457
2019년2분기,발달상권,영등포역_2,영등포구,영등포동,1283440,789,560,727271,556168,809461,473978,577,212,241,319
2019년1분기,발달상권,도산공원사거리_1,강남구,압구정동,181398,274,5906,99612,81786,149166,32231,129,145,3015,2891
2019년2분기,발달상권,도산공원사거리_1,강남구,압구정동,216278,274,3595,115857,100420,176800,39477,129,145,1700,1895
2019년1분기,발달상권,영등포역_3,영등포구,영등포동,893072,484,944,412722,480347,599162,293910,292,192,563,381
2019년2분기,발달상권,영등포역_3,영등포구,영등포동,1059812,484,137,482606,577207,696956,362861,292,192,77,60
2019년1분기,발달상권,남영역,용산구,남영동,105936,238,12123,58083,47853,82225,23709,103,135,6406,5717
2019년2분기,발달상권,남영역,용산구,남영동,133603,238,6921,71255,62347,104865,28740,103,135,4022,2899
2019년1분기,발달상권,서울 용산구 숙대입구역,용산구,용산2가동,137557,487,5761,74711,62845,107152,30400,278,209,3373,2388
2019년2분기,발달상권,서울 용산구 숙대입구역,용산구,용산2가동,165495,487,2911,87600,77895,129247,36247,278,209,571,2340
2019년1분기,발달상권,공덕역,마포구,아현동,115087,43,4855,60483,54605,93332,21755,32,11,3061,1794
2019년2분기,발달상권,공덕역,마포구,아현동,140247,43,2470,73263,66983,113222,27025,32,11,1444,1026
2019년1분기,발달상권,관악구 사당역_3,관악구,남현동,220730,307,2050,119318,101413,158683,62047,148,159,1363,687
2019년2분기,발달상권,관악구 사당역_3,관악구,남현동,260644,307,1530,138639,122004,187512,73132,148,159,1124,406
2019년1분기,발달상권,포이사거리_2,서초구,양재2동,230427,1856,15004,145115,85314,192929,37500,1011,845,8391,6613
2019년2분기,발달상권,포이사거리_2,서초구,양재2동,271215,1856,11006,164397,106819,224070,47150,1011,845,6153,4853
2019년1분기,발달상권,포이사거리_1,강남구,개포4동,56677,93,582,35849,20828,45256,11422,51,42,326,256
2019년2분기,발달상권,포이사거리_1,강남구,개포4동,65705,93,119,39472,26233,52335,13370,51,42,69,50
2019년1분기,발달상권,은마아파트입구사거리_4,강남구,대치2동,132913,370,498,69746,63167,92687,40224,195,175,194,304
2019년2분기,발달상권,은마아파트입구사거리_4,강남구,대치2동,143662,370,544,73625,70037,97776,45886,195,175,234,310
2019년1분기,발달상권,서울 강남구 한티역,강남구,대치4동,433906,2102,1356,195968,237939,308680,125225,994,1108,659,697
2019년2분기,발달상권,서울 강남구 한티역,강남구,대치4동,498335,2102,730,217859,280480,344202,154135,994,1108,391,339
2019년1분기,발달상권,신대방삼거리역,동작구,상도3동,302655,1243,672,153168,149488,218452,84204,590,653,287,385
2019년2분기,발달상권,신대방삼거리역,동작구,상도3동,355444,1243,405,177741,177700,254981,100462,590,653,258,147
2019년1분기,발달상권,여의도 시범아파트앞,영등포구,여의동,160306,1445,13574,84024,76283,121100,39207,685,760,6841,6733
2019년2분기,발달상권,여의도 시범아파트앞,영등포구,여의동,201288,1445,12813,104983,96305,153355,47936,685,760,7555,5258
2019년1분기,발달상권,학동사거리_1,강남구,논현2동,390620,415,8375,205502,185119,309703,80917,205,210,4508,3867
2019년2분기,발달상권,학동사거리_1,강남구,논현2동,469901,415,3887,237383,232517,371099,98799,205,210,2444,1443
2019년1분기,발달상권,서울 영등포구 영등포시장역,영등포구,영등포동,370314,1593,982,213671,156643,250135,120184,1023,570,614,368
2019년2분기,발달상권,서울 영등포구 영등포시장역,영등포구,영등포동,424148,1593,620,243680,180466,283011,141139,1023,570,394,226
2019년1분기,발달상권,서울 마포구 공덕역_2,마포구,아현동,144754,22,957,79617,65137,116331,28423,11,11,495,462
2019년2분기,발달상권,서울 마포구 공덕역_2,마포구,아현동,178278,22,3874,95599,82679,142873,35404,11,11,2494,1380
2019년1분기,발달상권,어린이대공원역,광진구,군자동,398502,537,169,213452,185050,281701,116800,309,228,86,83
2019년2분기,발달상권,어린이대공원역,광진구,군자동,466095,537,47,249047,217048,328303,137796,309,228,15,32
2019년1분기,발달상권,서울 강동구 명일역,강동구,명일1동,519986,1999,1407,253366,266622,374243,145745,992,1007,444,963
2019년2분기,발달상권,서울 강동구 명일역,강동구,명일1동,770559,1999,663,352835,417721,546996,223568,992,1007,252,411
2019년1분기,발달상권,등촌역,양천구,목3동,172081,1292,633,86607,85473,128670,43412,580,712,246,387
2019년2분기,발달상권,등촌역,양천구,목3동,209879,1292,111,103433,106446,155886,53993,580,712,55,56
2019년1분기,발달상권,가산디지털단지역_1,금천구,가산동,34106,27,22554,23624,10483,31480,2628,16,11,14370,8184
2019년2분기,발달상권,가산디지털단지역_1,금천구,가산동,37278,27,17408,25907,11372,33938,3340,16,11,11968,5440
2019년1분기,발달상권,관악구 사당역_2,동작구,사당1동,522883,924,1647,281234,241650,380757,142123,440,484,856,791
2019년2분기,발달상권,관악구 사당역_2,동작구,사당1동,610292,924,1216,322686,287607,446323,163965,440,484,576,640
2019년1분기,발달상권,가산디지털단지역_2,금천구,가산동,90016,681,41516,60268,29748,82869,7147,362,319,26488,15028
2019년2분기,발달상권,가산디지털단지역_2,금천구,가산동,114786,681,35995,75333,39452,105024,9762,362,319,22069,13926
2019년1분기,발달상권,서울 강남구 역삼역_1,강남구,역삼1동,959556,5470,32290,559172,400388,813143,146404,2800,2670,19359,12931
2019년2분기,발달상권,서울 강남구 역삼역_1,강남구,역삼1동,1171808,5470,25120,663720,508091,996794,175015,2800,2670,16158,8962
2019년1분기,발달상권,대림역_2,구로구,구로5동,88003,2626,8108,48386,39616,66097,21907,1238,1388,5936,2172
2019년2분기,발달상권,대림역_2,구로구,구로5동,107692,2626,7362,57581,50112,80689,27003,1238,1388,5460,1902
2019년1분기,발달상권,역삼역_2,강남구,역삼2동,220088,393,6667,132778,87312,183649,36439,265,128,3349,3318
2019년2분기,발달상권,역삼역_2,강남구,역삼2동,255175,393,10035,148933,106242,211202,43973,265,128,4561,5474
2019년1분기,발달상권,학동사거리_2,강남구,청담동,109733,447,2897,55005,54727,79362,30371,221,226,2139,758
2019년2분기,발달상권,학동사거리_2,강남구,청담동,139408,447,2344,68240,71165,101112,38296,221,226,1351,993
2019년1분기,발달상권,서울 양천구 신정네거리역_2,양천구,신정4동,14309,288,49,7482,6827,10469,3840,146,142,27,22
2019년2분기,발달상권,서울 양천구 신정네거리역_2,양천구,신정4동,15353,288,31,8122,7230,11151,4201,146,142,21,10
2019년1분기,발달상권,서울 영등포구 여의도역_1,영등포구,여의동,678692,1359,49466,411824,266869,590100,88591,655,704,27413,22053
2019년2분기,발달상권,서울 영등포구 여의도역_1,영등포구,여의동,864181,1359,20996,513846,350337,743427,120755,655,704,13276,7720
2019년1분기,발달상권,청담사거리_1,강남구,청담동,98945,255,2085,44056,54892,76798,22150,114,141,640,1445
2019년2분기,발달상권,청담사거리_1,강남구,청담동,130763,255,503,56265,74496,101615,29148,114,141,192,311
2019년1분기,발달상권,서울 마포구 홍대입구역_1,마포구,서교동,392446,657,3131,202558,189888,297506,94938,317,340,1518,1613
2019년2분기,발달상권,서울 마포구 홍대입구역_1,마포구,서교동,461059,657,1608,235423,225640,347371,113689,317,340,858,750
2019년1분기,발달상권,강서구청,강서구,화곡6동,725031,2954,5321,410241,314791,507186,217844,1456,1498,3082,2239
2019년2분기,발달상권,강서구청,강서구,화곡6동,820778,2954,4335,456852,363930,568875,251905,1456,1498,2630,1705
2019년1분기,발달상권,신촌역,마포구,대흥동,1764795,1175,5384,796230,968565,1268196,496604,607,568,2673,2711
2019년2분기,발달상권,신촌역,마포구,대흥동,1981295,1175,849,868465,1112829,1409332,571970,607,568,329,520
2019년1분기,발달상권,관악구 사당역_1,서초구,방배2동,667910,929,3324,360422,307489,481732,186177,446,483,1194,2130
2019년2분기,발달상권,관악구 사당역_1,서초구,방배2동,749141,929,5377,399586,349555,541611,207532,446,483,2218,3159
2019년1분기,발달상권,서울 관악구 서울대입구역_1,관악구,청룡동,2296232,6715,3202,1183426,1112808,1652998,643238,3076,3639,1502,1700
2019년2분기,발달상권,서울 관악구 서울대입구역_1,관악구,청룡동,2684062,6715,1561,1363289,1320771,1926721,757348,3076,3639,862,699
2019년1분기,발달상권,구로디지털단지역,구로구,가리봉동,26611,358,115,16975,9637,19678,6934,206,152,78,37
2019년2분기,발달상권,구로디지털단지역,구로구,가리봉동,40476,358,101,25150,15328,29828,10651,206,152,74,27
2019년1분기,발달상권,가산디지털단지역_3,금천구,가산동,303530,1748,37770,181994,121536,241382,62148,971,777,22520,15250
2019년2분기,발달상권,가산디지털단지역_3,금천구,가산동,388331,1748,25379,229150,159178,301941,86385,971,777,15619,9760
2019년1분기,발달상권,구로역,구로구,구로5동,281662,690,458,137257,144405,183882,97777,332,358,149,309
2019년2분기,발달상권,구로역,구로구,구로5동,350255,690,242,173547,176707,227954,122299,332,358,109,133
2019년1분기,발달상권,선릉역_1,강남구,역삼2동,935778,1337,19230,516583,419195,792321,143454,590,747,11361,7869
2019년2분기,발달상권,선릉역_1,강남구,역삼2동,1194967,1337,27712,657544,537424,1005642,189323,590,747,18453,9259
2019년1분기,발달상권,서울 강남구 강남역_2,서초구,서초4동,2729589,3089,12707,1286733,1442859,2034341,695264,1390,1699,5534,7173
2019년2분기,발달상권,서울 강남구 강남역_2,서초구,서초4동,2970673,3089,9238,1401042,1569635,2174498,796181,1390,1699,4452,4786
2019년1분기,발달상권,석촌역,송파구,석촌동,17509,3,216,8947,8562,13441,4067,2,1,162,54
2019년2분기,발달상권,석촌역,송파구,석촌동,21488,3,183,11169,10319,16157,5331,2,1,138,45
2019년1분기,발달상권,청담사거리_2,강남구,청담동,89569,373,920,44139,45431,70950,18619,181,192,327,593
2019년2분기,발달상권,청담사거리_2,강남구,청담동,108544,373,1350,53653,54891,85389,23155,181,192,711,639
2019년1분기,발달상권,청담역_1,강남구,청담동,98112,213,4644,49821,48293,74718,23396,101,112,2935,1709
2019년2분기,발달상권,청담역_1,강남구,청담동,128749,213,5401,63710,65038,98030,30716,101,112,3449,1952
2019년1분기,발달상권,청담역_2,강남구,청담동,210052,1060,6290,107891,102157,161605,48447,495,565,4287,2003
2019년2분기,발달상권,청담역_2,강남구,청담동,292264,1060,4354,148835,143429,217536,74731,495,565,3343,1011
2019년1분기,발달상권,영등포유통상가,영등포구,당산1동,50985,518,2041,28881,22104,39853,11133,283,235,1208,833
2019년2분기,발달상권,영등포유통상가,영등포구,당산1동,59969,518,1647,34520,25449,46541,13428,283,235,1042,605
2019년1분기,골목상권,상암로4길,강동구,천호2동,268202,3269,488,140018,128184,193561,74637,1651,1618,277,211
2019년2분기,골목상권,상암로4길,강동구,천호2동,310182,3269,256,158608,151577,221195,88991,1651,1618,160,96
2019년1분기,골목상권,상암로51길,강동구,명일1동,230524,3008,489,118930,111591,156780,73743,1447,1561,166,323
2019년2분기,골목상권,상암로51길,강동구,명일1동,367433,3008,384,181207,186228,249844,117590,1447,1561,174,210
2019년1분기,골목상권,상암로5길,강동구,암사2동,331337,1937,649,170337,161001,238039,93300,966,971,289,360
2019년2분기,골목상권,상암로5길,강동구,암사2동,376841,1937,317,191386,185453,267609,109232,966,971,129,188
2019년1분기,골목상권,상일로5길,강동구,상일동,43115,1274,437,29322,13796,37459,5654,643,631,194,243
2019년2분기,골목상권,상일로5길,강동구,상일동,49299,1274,176,33590,15710,41415,7884,643,631,123,53
2019년1분기,발달상권,서울 관악구 서울대입구역_2,관악구,행운동,251301,560,248,126251,125051,177757,73545,293,267,106,142
2019년2분기,발달상권,서울 관악구 서울대입구역_2,관악구,행운동,286204,560,79,140843,145363,202985,83219,293,267,38,41
2019년1분기,발달상권,양재역_1,서초구,양재1동,37463,8,1363,20664,16799,29728,7737,5,3,603,760
2019년2분기,발달상권,양재역_1,서초구,양재1동,56903,8,522,30794,26109,45506,11396,5,3,321,201
2019년1분기,발달상권,양재역_2,서초구,양재1동,520978,910,5961,280566,240412,415932,105045,425,485,2597,3364
2019년2분기,발달상권,양재역_2,서초구,양재1동,647557,910,4149,338356,309201,513623,133937,425,485,2003,2146
2019년1분기,발달상권,서울 송파구 석촌역_1,송파구,송파1동,69132,201,238,31493,37639,55169,13962,87,114,121,117
2019년2분기,발달상권,서울 송파구 석촌역_1,송파구,송파1동,85919,201,225,39174,46746,67160,18761,87,114,145,80
2019년1분기,발달상권,서울 강남구 역삼역_2,강남구,역삼1동,766807,1035,35830,448313,318490,616781,150023,519,516,23745,12085
2019년2분기,발달상권,서울 강남구 역삼역_2,강남구,역삼1동,833542,1035,19816,483966,349581,668152,165391,519,516,16079,3737
2019년1분기,발달상권,선릉역_2,강남구,대치4동,2490355,4251,21601,1323961,1166395,1998425,491932,1937,2314,12688,8913
2019년2분기,발달상권,선릉역_2,강남구,대치4동,2955750,4251,27366,1550890,1404856,2352991,602762,1937,2314,16796,10570
2019년1분기,발달상권,청담사거리_3,강남구,청담동,71493,922,3459,35531,35964,55306,16186,426,496,1125,2334
2019년2분기,발달상권,청담사거리_3,강남구,청담동,88654,922,3033,42610,46044,67864,20792,426,496,2097,936
2019년1분기,발달상권,서울 영등포구 여의도역_2,영등포구,여의동,500309,18,56221,302332,197976,428476,71831,15,3,36723,19498
2019년2분기,발달상권,서울 영등포구 여의도역_2,영등포구,여의동,611623,18,31529,359557,252066,515284,96340,15,3,20808,10721
2019년1분기,발달상권,신사동 가로수길,강남구,신사동,2383964,3852,25750,1102220,1281747,1791992,591976,1799,2053,11279,14471
2019년2분기,발달상권,신사동 가로수길,강남구,신사동,2922729,3852,15305,1338718,1584009,2175850,746883,1799,2053,7796,7509
2019년1분기,골목상권,성내로5길,강동구,성내1동,430105,3614,1516,213061,217050,323684,106424,1751,1863,844,672
2019년2분기,골목상권,성내로5길,강동구,성내1동,509787,3614,1138,250256,259531,374555,135242,1751,1863,709,429
2019년1분기,골목상권,성안로3길,강동구,성내1동,364875,4757,1781,190732,174144,280232,84642,2342,2415,1077,704
2019년2분기,골목상권,성안로3길,강동구,성내1동,435439,4757,2085,224690,210748,327302,108135,2342,2415,1262,823
2019년1분기,골목상권,암사길,강동구,암사1동,365510,7132,257,184009,181506,258574,106938,3599,3533,116,141
2019년2분기,골목상권,암사길,강동구,암사1동,414569,7132,251,207266,207297,289391,125175,3599,3533,153,98
2019년1분기,발달상권,서울 관악구 신림역_1,관악구,서원동,1030607,687,1442,558926,471682,670299,360308,300,387,736,706
2019년2분기,발달상권,서울 관악구 신림역_1,관악구,서원동,1169432,687,1369,625905,543529,758044,411384,300,387,485,884
2019년1분기,발달상권,서울 관악구 신림역_2,관악구,서원동,184398,1647,462,97475,86923,128142,56258,858,789,167,295
2019년2분기,발달상권,서울 관악구 신림역_2,관악구,서원동,216265,1647,170,115077,101188,149570,66696,858,789,57,113
2019년1분기,발달상권,서울 서초구 남부터미널역_1,서초구,서초1동,212997,1204,4040,125168,87828,170824,42175,578,626,2601,1439
2019년2분기,발달상권,서울 서초구 남부터미널역_1,서초구,서초1동,243096,1204,2467,140013,103082,193816,49279,578,626,1466,1001
2019년1분기,발달상권,서울 송파구 석촌역_2,송파구,송파1동,125550,594,354,61762,63789,91160,34391,295,299,193,161
2019년2분기,발달상권,서울 송파구 석촌역_2,송파구,송파1동,153997,594,569,73176,80822,109077,44922,295,299,313,256
2019년1분기,발달상권,서울 강남구 선릉역_1,강남구,삼성2동,256176,676,29179,140069,116104,211063,45114,329,347,12392,16787
2019년2분기,발달상권,서울 강남구 선릉역_1,강남구,삼성2동,292296,676,16664,154071,138224,240598,51697,329,347,6446,10218
2019년1분기,발달상권,서울 서초구 강남역,강남구,역삼1동,3805994,3214,35271,1866661,1939331,2882969,923029,1631,1583,19691,15580
2019년2분기,발달상권,서울 서초구 강남역,강남구,역삼1동,4485240,3214,23161,2164054,2321182,3369677,1115564,1631,1583,13139,10022
2019년1분기,발달상권,오목교역,양천구,목1동,194151,869,303,90481,103668,132614,61539,429,440,139,164
2019년2분기,발달상권,오목교역,양천구,목1동,233956,869,114,109291,124665,157072,76882,429,440,58,56
2019년1분기,발달상권,서울 강동구 둔촌동역,강동구,성내3동,59611,800,687,32499,27113,42251,17360,425,375,325,362
2019년2분기,발달상권,서울 강동구 둔촌동역,강동구,성내3동,66311,800,302,35464,30848,46453,19862,425,375,132,170
2019년1분기,발달상권,압구정 로데오거리_1,강남구,청담동,536079,604,10220,238945,297135,403547,132528,280,324,3605,6615
2019년2분기,발달상권,압구정 로데오거리_1,강남구,청담동,742380,604,14181,324622,417755,558685,183693,280,324,6988,7193
2019년1분기,골목상권,양재대로101길,강동구,성내3동,558456,4732,655,278953,279502,399551,158903,2277,2455,357,298
2019년2분기,골목상권,양재대로101길,강동구,성내3동,692910,4732,672,346971,345932,493299,199608,2277,2455,297,375
2019년1분기,골목상권,양재대로116길,강동구,길동,182985,1521,170,93199,89783,134129,48858,733,788,60,110
2019년2분기,골목상권,양재대로116길,강동구,길동,227819,1521,71,115620,112198,165856,61964,733,788,37,34
2019년1분기,골목상권,양재대로124길,강동구,길동,325183,4519,500,163699,161486,231472,93703,2261,2258,269,231
2019년2분기,골목상권,양재대로124길,강동구,길동,489484,4519,479,238988,250497,349796,139693,2261,2258,271,208
2019년1분기,발달상권,서울 서초구 방배역,서초구,방배1동,444291,1227,2820,226518,217774,347626,96668,583,644,1547,1273
2019년2분기,발달상권,서울 서초구 방배역,서초구,방배1동,586636,1227,1802,287776,298861,468288,118349,583,644,1019,783
2019년1분기,발달상권,매봉역,강남구,도곡2동,76271,572,2456,43784,32485,60547,15723,290,282,1402,1054
2019년2분기,발달상권,매봉역,강남구,도곡2동,93124,572,7223,52091,41031,73106,20017,290,282,4863,2360
2019년1분기,발달상권,문정역,송파구,문정1동,75758,406,131,42250,33508,57715,18044,223,183,79,52
2019년2분기,발달상권,문정역,송파구,문정1동,104650,406,88,58277,46373,80385,24265,223,183,50,38
2019년1분기,발달상권,서울 강남구 선릉역_2,강남구,역삼1동,759758,2167,16076,430077,329682,642369,117385,1065,1102,9844,6232
2019년2분기,발달상권,서울 강남구 선릉역_2,강남구,역삼1동,881198,2167,40349,487293,393909,745733,135468,1065,1102,21297,19052
2019년1분기,발달상권,삼성역_1,강남구,대치2동,654418,1511,30803,381513,272903,544212,110203,740,771,19253,11550
2019년2분기,발달상권,삼성역_1,강남구,대치2동,861159,1511,27060,489095,372063,709445,151716,740,771,17796,9264
2019년1분기,발달상권,서울 영등포구 영등포구청역,영등포구,당산1동,439078,1287,884,252483,186595,341805,97271,666,621,465,419
2019년2분기,발달상권,서울 영등포구 영등포구청역,영등포구,당산1동,534167,1287,434,297818,236349,411773,122390,666,621,269,165
2019년1분기,발달상권,서울 강남구 압구정역,강남구,압구정동,723946,1865,10385,334355,389588,565609,158335,851,1014,4717,5668
2019년2분기,발달상권,서울 강남구 압구정역,강남구,압구정동,855384,1865,9378,389825,465560,660234,195144,851,1014,4528,4850
2019년1분기,발달상권,압구정 로데오거리_2,강남구,압구정동,1720205,1313,12954,779053,941149,1258206,461990,635,678,4842,8112
2019년2분기,발달상권,압구정 로데오거리_2,강남구,압구정동,2172952,1313,8894,972907,1200043,1589244,583711,635,678,3075,5819
2019년1분기,골목상권,양재대로133길,강동구,천호1동,237893,4987,342,113617,124273,170433,67460,2457,2530,149,193
2019년2분기,골목상권,양재대로133길,강동구,천호1동,266336,4987,318,131466,134865,187894,78437,2457,2530,168,150
2019년1분기,골목상권,양재대로91길,강동구,성내3동,285317,4192,395,156409,128911,203190,82122,2055,2137,224,171
2019년2분기,골목상권,양재대로91길,강동구,성내3동,329014,4192,354,175907,153105,231296,97716,2055,2137,228,126
2019년1분기,골목상권,양재대로95길,강동구,성내3동,232891,3619,741,116749,116142,165249,67649,1783,1836,404,337
2019년2분기,골목상권,양재대로95길,강동구,성내3동,273704,3619,605,134798,138905,193774,79930,1783,1836,330,275
2019년1분기,발달상권,양재역,강남구,도곡1동,541146,1698,2585,292570,248577,430849,110296,762,936,1352,1233
2019년2분기,발달상권,양재역,강남구,도곡1동,620846,1698,1019,326719,294126,490608,130234,762,936,522,497
2019년1분기,발달상권,구로디지탈1단지,구로구,구로3동,601887,125,69308,375858,226029,535144,66749,68,57,42662,26646
2019년2분기,발달상권,구로디지탈1단지,구로구,구로3동,755150,125,46412,462761,292392,668749,86402,68,57,29926,16486
2019년1분기,발달상권,서울 서초구 남부터미널역_2,서초구,서초3동,780812,1764,7655,449058,331755,612070,168739,868,896,5244,2411
2019년2분기,발달상권,서울 서초구 남부터미널역_2,서초구,서초3동,855416,1764,3694,474258,381155,667403,188014,868,896,2446,1248
2019년1분기,발달상권,서울 관악구 신림역_3,관악구,신림동,621640,1168,448,326818,294822,418271,203374,634,534,171,277
2019년2분기,발달상권,서울 관악구 신림역_3,관악구,신림동,739890,1168,93,389042,350849,495761,244130,634,534,33,60
2019년1분기,발달상권,삼정역_1,강남구,역삼1동,221781,86,3558,116246,105533,179688,42092,37,49,1541,2017
2019년2분기,발달상권,삼정역_1,강남구,역삼1동,263023,86,1881,133942,129080,214222,48799,37,49,839,1042
2019년1분기,발달상권,삼정역_2,강남구,논현2동,273342,686,2885,151681,121661,221939,51407,332,354,1564,1321
2019년2분기,발달상권,삼정역_2,강남구,논현2동,329672,686,1226,186075,143598,266174,63498,332,354,745,481
2019년1분기,발달상권,삼성역_2,강남구,대치2동,144044,9,9260,87604,56440,127767,16278,6,3,4425,4835
2019년2분기,발달상권,삼성역_2,강남구,대치2동,193887,9,11421,116449,77438,172979,20910,6,3,6149,5272
2019년1분기,발달상권,국회의사당역_1,영등포구,여의동,17047,145,2806,9742,7305,14770,2277,80,65,1542,1264
2019년2분기,발달상권,국회의사당역_1,영등포구,여의동,23171,145,4489,13040,10131,19640,3533,80,65,3474,1015
2019년1분기,발달상권,서울 용산구 신용산역,용산구,한강로동,173501,390,12319,101129,72372,136927,36574,195,195,5744,6575
2019년2분기,발달상권,서울 용산구 신용산역,용산구,한강로동,209460,390,968,118849,90610,160098,49364,195,195,657,311
2019년1분기,발달상권,국회의사당역_2,영등포구,여의동,465381,721,22362,290315,175066,400491,64889,368,353,12621,9741
2019년2분기,발달상권,국회의사당역_2,영등포구,여의동,543108,721,18939,326565,216544,459985,83126,368,353,11162,7777
2019년1분기,골목상권,양재대로96길,강동구,둔촌2동,351141,3526,233,185148,165994,257343,93803,1756,1770,137,96
2019년2분기,골목상권,양재대로96길,강동구,둔촌2동,406199,3526,229,206859,199339,294858,111340,1756,1770,149,80
2019년1분기,골목상권,올림픽로48길,강동구,성내1동,262431,1562,2031,135146,127285,208071,54367,752,810,1260,771
2019년2분기,골목상권,올림픽로48길,강동구,성내1동,360340,1562,2051,177314,183024,279401,80939,752,810,1337,714
2019년1분기,골목상권,올림픽로71길,강동구,천호2동,307471,2561,225,155053,152422,216397,91074,1321,1240,145,80
2019년2분기,골목상권,올림픽로71길,강동구,천호2동,408350,2561,194,197677,210674,279094,129253,1321,1240,103,91
2019년1분기,발달상권,서울 강남구 수서역,강남구,수서동,426541,1480,12474,237108,189431,337807,88733,683,797,6372,6102
2019년2분기,발달상권,서울 강남구 수서역,강남구,수서동,509791,1480,14566,281377,228414,398227,111564,683,797,8218,6348
2019년1분기,발달상권,서울 서초구 남부터미널역_3,서초구,서초1동,305626,575,4845,162451,143174,240284,65341,249,326,1969,2876
2019년2분기,발달상권,서울 서초구 남부터미널역_3,서초구,서초1동,339295,575,3086,174384,164911,267214,72081,249,326,1255,1831
2019년1분기,발달상권,동작구 총신대입구역_2,서초구,방배4동,947384,1812,2016,469010,478375,697635,249754,779,1033,1090,926
2019년2분기,발달상권,동작구 총신대입구역_2,서초구,방배4동,1148133,1812,1952,559679,588457,842634,305500,779,1033,949,1003
2019년1분기,발달상권,강남구 논현역_1,서초구,반포1동,958505,1973,4234,520348,438156,729238,229268,1023,950,2242,1992
2019년2분기,발달상권,강남구 논현역_1,서초구,반포1동,1126552,1973,2888,597450,529099,857435,269117,1023,950,1439,1449
2019년1분기,발달상권,신천역,송파구,잠실본동,1470226,2803,7698,801671,668557,1024555,445663,1369,1434,4381,3317
2019년2분기,발달상권,신천역,송파구,잠실본동,1856824,2803,4717,994330,862494,1259628,597204,1369,1434,2610,2107
2019년1분기,발달상권,선정릉역_1,강남구,삼성2동,60791,643,3281,34099,26690,49913,10878,281,362,2011,1270
2019년2분기,발달상권,선정릉역_1,강남구,삼성2동,73696,643,2523,41345,32350,60662,13035,281,362,1560,963
2019년1분기,발달상권,강남구 논현역_2,강남구,논현1동,1422930,3931,9710,778237,644692,1086948,335986,1886,2045,5491,4219
2019년2분기,발달상권,강남구 논현역_2,강남구,논현1동,1722636,3931,9583,924580,798058,1324035,398601,1886,2045,5755,3828
2019년1분기,발달상권,용산 전자상가_1,용산구,한강로동,72651,1447,12218,40979,31672,53287,19365,671,776,7169,5049
2019년2분기,발달상권,용산 전자상가_1,용산구,한강로동,94885,1447,3414,53686,41198,69098,25788,671,776,2466,948
2019년1분기,발달상권,용산구청,용산구,이태원1동,18382,107,1979,8808,9573,10762,7619,47,60,1007,972
2019년2분기,발달상권,용산구청,용산구,이태원1동,23908,107,284,11480,12428,13593,10316,47,60,197,87
2019년1분기,발달상권,용산 전자상가_2,용산구,한강로동,18909,178,2290,14108,4801,16199,2710,98,80,1883,407
2019년2분기,발달상권,용산 전자상가_2,용산구,한강로동,39055,178,594,28895,10160,32076,6978,98,80,475,119
2019년1분기,발달상권,목동사거리,양천구,목4동,56567,59,182,28808,27759,40171,16398,35,24,58,124
2019년2분기,발달상권,목동사거리,양천구,목4동,67373,59,63,33219,34154,47490,19886,35,24,17,46
2019년1분기,골목상권,올림픽로77길,강동구,천호2동,198830,2618,144,104613,94219,143272,55561,1338,1280,84,60
2019년2분기,골목상권,올림픽로77길,강동구,천호2동,269793,2618,211,139580,130218,189711,80085,1338,1280,119,92
2019년1분기,골목상권,올림픽로78길,강동구,천호2동,124002,1738,339,61729,62273,88342,35660,905,833,117,222
2019년2분기,골목상권,올림픽로78길,강동구,천호2동,161433,1738,99,77190,84243,113617,47817,905,833,44,55
2019년1분기,골목상권,올림픽로80길,강동구,천호2동,164956,2047,300,86295,78660,110278,54677,1053,994,100,200
2019년2분기,골목상권,올림픽로80길,강동구,천호2동,202786,2047,135,103352,99435,133017,69769,1053,994,39,96
2019년1분기,발달상권,양재역_3,서초구,서초2동,611517,1858,8624,352242,259274,506162,105359,886,972,5484,3140
2019년2분기,발달상권,양재역_3,서초구,서초2동,699017,1858,8867,401701,297320,571865,127153,886,972,5289,3578
2019년1분기,발달상권,동작구 총신대입구역_1,동작구,사당2동,1423836,1176,1294,771228,652608,1006971,416866,554,622,636,658
2019년2분기,발달상권,동작구 총신대입구역_1,동작구,사당2동,1655386,1176,438,879679,775713,1165695,489696,554,622,188,250
2019년1분기,발달상권,서울 관악구 신림역_4,관악구,신림동,886251,3147,1154,459199,427052,608896,277355,1589,1558,529,625
2019년2분기,발달상권,서울 관악구 신림역_4,관악구,신림동,1048491,3147,418,535007,513485,716964,331529,1589,1558,169,249
2019년1분기,발달상권,신도림역,구로구,신도림동,816711,3227,7280,354989,461722,567811,248900,1551,1676,2951,4329
2019년2분기,발달상권,신도림역,구로구,신도림동,971846,3227,2078,423193,548654,671839,300006,1551,1676,1248,830
2019년1분기,발달상권,포스코사거리_1,강남구,삼성2동,663168,2118,10442,387830,275338,546482,116693,1036,1082,6163,4279
2019년2분기,발달상권,포스코사거리_1,강남구,삼성2동,871985,2118,15421,493580,378409,718517,153474,1036,1082,8733,6688
2019년1분기,발달상권,한남오거리,용산구,한남동,155970,157,1156,77743,78227,120431,35536,79,78,679,477
2019년2분기,발달상권,한남오거리,용산구,한남동,195040,157,659,95712,99329,150119,44920,79,78,450,209
2019년1분기,발달상권,서울 용산구 이태원역,용산구,이태원1동,767188,876,1473,410620,356569,430858,336330,482,394,863,610
2019년2분기,발달상권,서울 용산구 이태원역,용산구,이태원1동,935323,876,846,494514,440809,502569,432747,482,394,505,341
2019년1분기,발달상권,용산 전자상가_3,용산구,원효로2동,54323,249,2637,39905,14417,45565,8758,122,127,1941,696
2019년2분기,발달상권,용산 전자상가_3,용산구,원효로2동,78188,249,2244,54678,23512,63614,14572,122,127,1656,588
2019년1분기,골목상권,올림픽로98길,강동구,암사1동,178721,3215,176,92051,86671,123569,55155,1576,1639,99,77
2019년2분기,골목상권,올림픽로98길,강동구,암사1동,205992,3215,213,105432,100560,141226,64769,1576,1639,155,58
2019년1분기,골목상권,진황도로27길,강동구,천호3동,460621,7755,452,237816,222813,328629,131996,3899,3856,225,227
2019년2분기,골목상권,진황도로27길,강동구,천호3동,538751,7755,290,273621,265127,377444,161310,3899,3856,173,117
2019년1분기,골목상권,진황도로47길,강동구,길동,403302,1801,190,205650,197654,294295,109005,887,914,83,107
2019년2분기,골목상권,진황도로47길,강동구,길동,467504,1801,186,235558,231947,338773,128734,887,914,89,97
2019년1분기,발달상권,뱅뱅사거리_1,강남구,도곡1동,169293,1069,4376,97675,71619,140423,28870,546,523,3049,1327
2019년2분기,발달상권,뱅뱅사거리_1,강남구,도곡1동,200317,1069,5288,112001,88317,165275,35049,546,523,4076,1212
2019년1분기,발달상권,뱅뱅사거리,서초구,서초2동,387416,1759,5660,217905,169512,320227,67192,755,1004,3302,2358
2019년2분기,발달상권,뱅뱅사거리,서초구,서초2동,436922,1759,6920,242912,194012,359390,77535,755,1004,4334,2586
2019년1분기,발달상권,개봉동 현대아파트 인근,구로구,개봉3동,280605,2655,620,137673,142931,200660,79945,1325,1330,196,424
2019년2분기,발달상권,개봉동 현대아파트 인근,구로구,개봉3동,306537,2655,276,146881,159655,216288,90250,1325,1330,131,145
2019년1분기,발달상권,포스코사거리_2,강남구,삼성1동,775961,700,18461,466025,309939,679821,96142,363,337,10767,7694
2019년2분기,발달상권,포스코사거리_2,강남구,삼성1동,1035166,700,15779,600691,434475,900913,134253,363,337,9200,6579
2019년1분기,발달상권,강남구 논현역_3,강남구,논현1동,140843,78,2978,80820,60023,115883,24957,28,50,1668,1310
2019년2분기,발달상권,강남구 논현역_3,강남구,논현1동,176951,78,4119,99887,77063,145762,31189,28,50,1341,2778
2019년1분기,발달상권,선정릉역_2,강남구,삼성2동,348030,3129,3671,184638,163396,278258,69775,1429,1700,2006,1665
2019년2분기,발달상권,선정릉역_2,강남구,삼성2동,436592,3129,4273,231250,205340,350514,86083,1429,1700,2944,1329
2019년1분기,발달상권,서울 강남구 학동역_1,강남구,논현1동,88508,896,2579,51093,37416,73300,15209,424,472,1598,981
2019년2분기,발달상권,서울 강남구 학동역_1,강남구,논현1동,101428,896,1762,57381,44044,82390,19036,424,472,1052,710
2019년1분기,발달상권,서울 광진구 강변역,광진구,구의3동,34489,198,2766,17735,16755,24416,10074,89,109,1747,1019
2019년2분기,발달상권,서울 광진구 강변역,광진구,구의3동,40197,198,2160,20634,19562,27908,12289,89,109,1695,465
2019년1분기,발달상권,당산역_1,영등포구,양평2동,525516,1061,859,286641,238874,371970,153546,475,586,412,447
2019년2분기,발달상권,당산역_1,영등포구,양평2동,659527,1061,331,356338,303190,467521,192006,475,586,183,148
2019년1분기,발달상권,용산 전자상가_4,용산구,원효로1동,38887,346,539,27849,11039,32134,6753,182,164,346,193
2019년2분기,발달상권,용산 전자상가_4,용산구,원효로1동,49988,346,349,34926,15062,40541,9446,182,164,252,97
2019년1분기,발달상권,용산 전자상가_5,용산구,원효로1동,146124,629,3269,100639,45487,121753,24374,367,262,2378,891
2019년2분기,발달상권,용산 전자상가_5,용산구,원효로1동,315868,629,2223,208320,107550,258740,57128,367,262,1678,545
2019년1분기,골목상권,천중로39길,강동구,천호1동,702516,6690,538,350388,352126,499422,203100,3286,3404,316,222
2019년2분기,골목상권,천중로39길,강동구,천호1동,697799,6690,597,342918,354886,489317,208483,3286,3404,389,208
2019년1분기,골목상권,천중로51길,강동구,명일1동,583220,4505,596,309241,273980,416983,166238,2182,2323,264,332
2019년2분기,골목상권,천중로51길,강동구,명일1동,776511,4505,824,396857,379655,542565,233943,2182,2323,549,275
2019년1분기,골목상권,천호대로162길,강동구,성내2동,192586,2704,234,96442,96140,135892,56688,1346,1358,103,131
2019년2분기,골목상권,천호대로162길,강동구,성내2동,223963,2704,244,110093,113867,154878,69081,1346,1358,142,102
2019년1분기,발달상권,교대역_1,서초구,서초3동,1731739,2611,24301,1006218,725519,1361336,370402,1321,1290,11781,12520
2019년2분기,발달상권,교대역_1,서초구,서초3동,2068248,2611,17111,1157521,910727,1616863,451384,1321,1290,8100,9011
2019년1분기,발달상권,보라매공원,동작구,신대방2동,524819,5095,11978,256098,268724,390919,133898,2411,2684,6495,5483
2019년2분기,발달상권,보라매공원,동작구,신대방2동,639282,5095,2357,299973,339312,472379,166906,2411,2684,1432,925
2019년1분기,발달상권,뱅뱅사거리_2,강남구,역삼1동,538529,2197,15677,308223,230307,447121,91406,964,1233,9515,6162
2019년2분기,발달상권,뱅뱅사거리_2,강남구,역삼1동,645365,2197,13297,365608,279760,535807,109563,964,1233,8922,4375
2019년1분기,발달상권,코엑스,강남구,삼성1동,50225,26,26319,25311,24913,38576,11648,17,9,15076,11243
2019년2분기,발달상권,코엑스,강남구,삼성1동,79398,26,18430,39454,39944,59916,19482,17,9,10279,8151
2019년1분기,발달상권,삼성역_3,강남구,삼성1동,131012,65,11446,82805,48207,116823,14189,49,16,7449,3997
2019년2분기,발달상권,삼성역_3,강남구,삼성1동,194216,65,29439,121132,73086,172723,21497,49,16,23456,5983
2019년1분기,발달상권,서울 동작구 노량진역,동작구,노량진1동,645191,1129,1445,375619,269572,479891,165300,564,565,965,480
2019년2분기,발달상권,서울 동작구 노량진역,동작구,노량진1동,707278,1129,590,407178,300100,517825,189455,564,565,313,277
2019년1분기,발달상권,서울 강동구 길동역,강동구,길동,1119708,3041,3638,577922,541783,797919,321791,1468,1573,1597,2041
2019년2분기,발달상권,서울 강동구 길동역,강동구,길동,1296100,3041,2749,656158,639944,920474,375632,1468,1573,1262,1487
2019년1분기,발달상권,서울 강동구 천호역_1,강동구,성내2동,497540,388,336,223622,273916,358752,138784,199,189,140,196
2019년2분기,발달상권,서울 강동구 천호역_1,강동구,성내2동,670970,388,178,300742,370231,479655,191316,199,189,74,104
2019년1분기,발달상권,당산역_2,영등포구,당산2동,219311,723,5817,121598,97712,161634,57680,310,413,3691,2126
2019년2분기,발달상권,당산역_2,영등포구,당산2동,274042,723,1672,151103,122940,201098,72947,310,413,1152,520
2019년1분기,골목상권,동광로1길,서초구,방배본동,169609,3406,1471,91243,78362,123450,46152,1575,1831,899,572
2019년2분기,골목상권,동광로1길,서초구,방배본동,198626,3406,1470,102153,96471,141632,56991,1575,1831,667,803
2019년1분기,골목상권,동광로39길,서초구,반포4동,127662,1674,705,58956,68706,94710,32954,754,920,349,356
2019년2분기,골목상권,동광로39길,서초구,반포4동,167686,1674,1217,75398,92290,122560,45126,754,920,833,384
2019년1분기,골목상권,동산로10길,서초구,양재2동,142201,3519,1766,81327,60872,108769,33433,1748,1771,854,912
2019년2분기,골목상권,동산로10길,서초구,양재2동,168580,3519,1650,94879,73701,127466,41112,1748,1771,1164,486
2019년1분기,골목상권,도산대로30길,강남구,논현2동,293285,905,2122,158489,134795,238612,54671,420,485,1036,1086
2019년2분기,골목상권,도산대로30길,강남구,논현2동,361868,905,2619,189626,172241,292797,69067,420,485,1317,1302
2019년1분기,골목상권,도산대로38길,강남구,논현2동,131192,1051,1159,72140,59050,107141,24053,484,567,623,536
2019년2분기,골목상권,도산대로38길,강남구,논현2동,160347,1051,1114,86180,74171,130265,30085,484,567,662,452
2019년1분기,골목상권,도산대로50길,강남구,논현2동,140095,2275,2054,71104,68991,109565,30526,1052,1223,1105,949
2019년2분기,골목상권,도산대로50길,강남구,논현2동,162306,2275,2456,79106,83203,126610,35699,1052,1223,1656,800
2019년1분기,골목상권,송이로36길,송파구,문정1동,378874,3364,1095,206644,172231,275032,103836,1702,1662,695,400
2019년2분기,골목상권,송이로36길,송파구,문정1동,463764,3364,1596,247065,216701,335904,127864,1702,1662,1066,530
2019년1분기,골목상권,송파대로30길,송파구,가락본동,493335,1584,1601,281776,211559,363888,129448,867,717,698,903
2019년2분기,골목상권,송파대로30길,송파구,가락본동,552465,1584,1969,307825,244637,404356,148106,867,717,1432,537
2019년1분기,골목상권,양재대로62길,송파구,가락본동,126941,1587,1204,70476,56467,95461,31482,822,765,697,507
2019년2분기,골목상권,양재대로62길,송파구,가락본동,148821,1587,6233,79222,69600,110475,38357,822,765,3834,2399
2019년1분기,골목상권,당곡길,관악구,보라매동,183615,1818,295,94125,89491,136575,47039,881,937,112,183
2019년2분기,골목상권,당곡길,관악구,보라매동,219149,1818,207,109374,109773,160844,58303,881,937,96,111
2019년1분기,골목상권,대학14길,관악구,대학동,112976,2996,20,74433,38539,79555,33420,2075,921,7,13
2019년2분기,골목상권,대학14길,관악구,대학동,102283,2996,70,66999,35282,70391,31895,2075,921,23,47
2019년1분기,골목상권,대학길,관악구,대학동,423002,1773,97,268527,154476,290108,132893,1108,665,41,56
2019년2분기,골목상권,대학길,관악구,대학동,454007,1773,55,287023,166984,309608,144395,1108,665,31,24
2019년1분기,골목상권,동산로19길,서초구,양재2동,133456,2075,1027,78600,54856,107737,25714,1047,1028,654,373
2019년2분기,골목상권,동산로19길,서초구,양재2동,158653,2075,1318,91425,67227,125731,32923,1047,1028,656,662
2019년1분기,골목상권,방배천로4안길,서초구,방배2동,94206,1197,778,44203,50002,67492,26715,528,669,443,335
2019년2분기,골목상권,방배천로4안길,서초구,방배2동,102610,1197,1082,49606,53004,72566,30047,528,669,468,614
2019년1분기,골목상권,마방로2길,서초구,양재2동,157310,1505,3566,92834,64472,122721,34596,750,755,2408,1158
2019년2분기,골목상권,마방로2길,서초구,양재2동,218476,1505,3386,123849,94625,162229,56247,750,755,2494,892
2019년1분기,골목상권,도산대로81길,강남구,청담동,132974,941,1942,64246,68730,102356,30622,419,522,556,1386
2019년2분기,골목상권,도산대로81길,강남구,청담동,164312,941,12220,73971,90340,125014,39296,419,522,10167,2053
2019년1분기,골목상권,도산대로89길,강남구,청담동,103493,1944,665,52406,51084,76466,27026,895,1049,310,355
2019년2분기,골목상권,도산대로89길,강남구,청담동,134233,1944,1366,66059,68174,97671,36565,895,1049,712,654
2019년1분기,골목상권,봉은사로109길,강남구,삼성1동,59562,2173,814,32156,27407,44501,15063,1037,1136,406,408
2019년2분기,골목상권,봉은사로109길,강남구,삼성1동,74171,2173,3073,38637,35536,53571,20598,1037,1136,2193,880
2019년1분기,골목상권,봉은사로29길,강남구,논현2동,260765,1239,3670,147943,112822,205913,54846,581,658,1718,1952
2019년2분기,골목상권,봉은사로29길,강남구,논현2동,304874,1239,2316,170146,134729,238612,66262,581,658,1703,613
2019년1분기,골목상권,양재대로64길,송파구,가락본동,353782,3669,1766,188989,164795,259767,94017,1878,1791,868,898
2019년2분기,골목상권,양재대로64길,송파구,가락본동,402696,3669,1422,207799,194899,292801,109894,1878,1791,813,609
2019년1분기,골목상권,양재대로71길,송파구,방이1동,296197,1517,2401,154129,142069,216139,80056,720,797,1585,816
2019년2분기,골목상권,양재대로71길,송파구,방이1동,349843,1517,2400,175220,174627,247184,102660,720,797,1739,661
2019년1분기,골목상권,양재대로72길,송파구,오금동,203662,2715,526,102438,101222,147559,56105,1321,1394,238,288
2019년2분기,골목상권,양재대로72길,송파구,오금동,242916,2715,225,116501,126414,173160,69754,1321,1394,118,107
2019년1분기,골목상권,미성5길,관악구,미성동,86582,4365,263,46131,40453,60129,26448,2147,2218,113,150
2019년2분기,골목상권,미성5길,관악구,미성동,118718,4365,376,61011,57706,79713,39007,2147,2218,204,172
2019년1분기,골목상권,법원단지9길,관악구,난곡동,244856,5210,42,120309,124547,163234,81614,2605,2605,20,22
2019년2분기,골목상권,법원단지9길,관악구,난곡동,298435,5210,172,150161,148277,196972,101471,2605,2605,110,62
2019년1분기,골목상권,법원단지길,관악구,난곡동,154259,1325,92,77281,76980,110816,43441,638,687,34,58
2019년2분기,골목상권,법원단지길,관악구,난곡동,182854,1325,34,90615,92242,129322,53533,638,687,10,24
2019년1분기,골목상권,복은길,관악구,서림동,166830,4138,87,96567,70262,115340,51493,2249,1889,41,46
2019년2분기,골목상권,복은길,관악구,서림동,178160,4138,599,101907,76251,121024,57144,2249,1889,378,221
2019년1분기,골목상권,바우뫼로39길,서초구,양재1동,178117,2791,2680,94557,83557,141557,36558,1339,1452,1675,1005
2019년2분기,골목상권,바우뫼로39길,서초구,양재1동,201926,2791,2853,106632,95293,157557,44369,1339,1452,1707,1146
2019년1분기,골목상권,반포대로9길,서초구,서초3동,146328,1630,572,83532,62796,111934,34397,786,844,357,215
2019년2분기,골목상권,반포대로9길,서초구,서초3동,165708,1630,532,87530,78181,123976,41735,786,844,297,235
2019년1분기,골목상권,방배로18길,서초구,방배1동,183652,1646,1631,91477,92176,141889,41764,762,884,811,820
2019년2분기,골목상권,방배로18길,서초구,방배1동,216814,1646,917,105979,110834,166207,50610,762,884,589,328
2019년1분기,골목상권,방배로35길,서초구,방배본동,211144,1599,1616,110207,100941,154412,56738,754,845,1052,564
2019년2분기,골목상권,방배로35길,서초구,방배본동,253635,1599,1386,126670,126963,182226,71408,754,845,874,512
2019년1분기,골목상권,봉은사로43길,강남구,논현2동,429548,3259,4240,232889,196658,347959,81595,1536,1723,2060,2180
2019년2분기,골목상권,봉은사로43길,강남구,논현2동,556272,3259,4389,290673,265597,447428,108837,1536,1723,2637,1752
2019년1분기,골목상권,봉은사로57길,강남구,삼성2동,300447,1646,750,163882,136569,238162,62287,735,911,493,257
2019년2분기,골목상권,봉은사로57길,강남구,삼성2동,303639,1646,477,156410,147228,238707,64933,735,911,278,199
2019년1분기,골목상권,봉은사로68길,강남구,삼성2동,62635,1490,1524,32692,29942,49494,13141,697,793,908,616
2019년2분기,골목상권,봉은사로68길,강남구,삼성2동,83425,1490,1383,42941,40486,65384,18037,697,793,854,529
2019년1분기,골목상권,오금로11길,송파구,방이2동,255076,4808,1028,139218,115861,181023,74049,2327,2481,605,423
2019년2분기,골목상권,오금로11길,송파구,방이2동,357196,4808,1152,189508,167692,250160,107036,2327,2481,720,432
2019년1분기,골목상권,오금로36길,송파구,가락본동,273625,2964,1661,146933,126691,208194,65433,1456,1508,916,745
2019년2분기,골목상권,오금로36길,송파구,가락본동,325820,2964,1470,170203,155619,246018,79801,1456,1508,1046,424
2019년1분기,골목상권,오금로46길,송파구,가락2동,211227,2594,1258,106109,105119,144394,66834,1296,1298,669,589
2019년2분기,골목상권,오금로46길,송파구,가락2동,252095,2594,780,124397,127697,169820,82277,1296,1298,409,371
2019년1분기,골목상권,봉천로13길,관악구,보라매동,60849,3807,222,29829,31019,42124,18725,1892,1915,83,139
2019년2분기,골목상권,봉천로13길,관악구,보라매동,76747,3807,358,37089,39659,51502,25255,1892,1915,106,252
2019년1분기,골목상권,봉천로33길,관악구,은천동,256033,3995,303,124448,131588,178783,77251,1966,2029,117,186
2019년2분기,골목상권,봉천로33길,관악구,은천동,307542,3995,188,146695,160844,213009,94534,1966,2029,119,69
2019년1분기,골목상권,서림7길,관악구,서림동,247210,4104,70,152043,95166,169848,77359,2699,1405,44,26
2019년2분기,골목상권,서림7길,관악구,서림동,272102,4104,124,162257,109845,185843,86259,2699,1405,65,59
2019년1분기,골목상권,방배로42길,서초구,방배본동,132861,1130,1401,61198,71661,100709,32150,528,602,1059,342
2019년2분기,골목상권,방배로42길,서초구,방배본동,180860,1130,853,81141,99719,136223,44637,528,602,701,152
2019년1분기,골목상권,사임당로17길,서초구,서초1동,239519,1089,1517,134722,104799,185502,54021,536,553,930,587
2019년2분기,골목상권,사임당로17길,서초구,서초1동,273532,1089,2107,150047,123485,211547,61986,536,553,1279,828
2019년1분기,골목상권,사평대로22길,서초구,반포4동,111856,1568,1570,53756,58100,82213,29641,713,855,822,748
2019년2분기,골목상권,사평대로22길,서초구,반포4동,233957,1568,1825,113554,120404,172107,61848,713,855,1099,726
2019년1분기,골목상권,삼성로115길,강남구,삼성2동,134827,2821,674,66735,68090,101177,33650,1312,1509,329,345
2019년2분기,골목상권,삼성로115길,강남구,삼성2동,177560,2821,837,85271,92289,133129,44432,1312,1509,420,417
2019년1분기,골목상권,삼성로147길,강남구,청담동,68190,1246,257,30212,37978,50934,17254,554,692,118,139
2019년2분기,골목상권,삼성로147길,강남구,청담동,88300,1246,204,38028,50274,65983,22316,554,692,93,111
2019년1분기,골목상권,삼성로57길,강남구,대치1동,443016,1730,318,220672,222340,293599,149421,904,826,114,204
2019년2분기,골목상권,삼성로57길,강남구,대치1동,466160,1730,2446,225570,240590,300749,165408,904,826,1558,888
2019년1분기,골목상권,풍성로25길,송파구,풍납1동,318295,1920,382,151844,166458,224785,93512,941,979,136,246
2019년2분기,골목상권,풍성로25길,송파구,풍납1동,429580,1920,77,211784,217802,300201,129378,941,979,38,39
2019년1분기,골목상권,강동대로53길,강동구,성내3동,309569,4215,1010,163002,146557,206818,102748,2140,2075,604,406
2019년2분기,골목상권,강동대로53길,강동구,성내3동,387356,4215,1182,204152,183214,254114,133259,2140,2075,759,423
2019년1분기,골목상권,고덕로10길,강동구,암사1동,200955,2111,402,101714,99240,142758,58198,1053,1058,133,269
2019년2분기,골목상권,고덕로10길,강동구,암사1동,230751,2111,819,115245,115504,162190,68557,1053,1058,385,434
2019년1분기,골목상권,승방길,관악구,남현동,126694,3158,678,63959,62738,86906,39788,1503,1655,452,226
2019년2분기,골목상권,승방길,관악구,남현동,152130,3158,520,75812,76321,104495,47635,1503,1655,404,116
2019년1분기,골목상권,신림동길,관악구,신림동,358572,4207,230,192808,165760,242894,115673,2164,2043,123,107
2019년2분기,골목상권,신림동길,관악구,신림동,436339,4207,695,231728,204609,293085,143257,2164,2043,410,285
2019년1분기,골목상권,신림로11길,관악구,대학동,171276,4647,109,101794,69482,118125,53153,2745,1902,55,54
2019년2분기,골목상권,신림로11길,관악구,대학동,170081,4647,238,101033,69049,115790,54287,2745,1902,154,84
2019년1분기,골목상권,사평대로26길,서초구,반포4동,46730,173,832,22711,24020,34548,12183,71,102,467,365
2019년2분기,골목상권,사평대로26길,서초구,반포4동,92769,173,615,45565,47203,69565,23204,71,102,402,213
2019년1분기,골목상권,사평대로57길,서초구,반포1동,383631,1219,184,188943,194690,256483,127147,542,677,97,87
2019년2분기,골목상권,사평대로57길,서초구,반포1동,438658,1219,84,213034,225624,288337,150321,542,677,47,37
2019년1분기,골목상권,서초대로15길,서초구,방배4동,197675,2418,475,104047,93631,142000,55677,1099,1319,283,192
2019년2분기,골목상권,서초대로15길,서초구,방배4동,241089,2418,519,125283,115805,169530,71557,1099,1319,325,194
2019년1분기,골목상권,삼성로63길,강남구,대치4동,541432,4355,719,270481,270955,357372,184057,2070,2285,293,426
2019년2분기,골목상권,삼성로63길,강남구,대치4동,575375,4355,1124,286025,289351,367813,207569,2070,2285,575,549
2019년1분기,골목상권,삼성로64길,강남구,대치2동,264485,2924,246,143413,121074,191239,73249,1554,1370,121,125
2019년2분기,골목상권,삼성로64길,강남구,대치2동,288048,2924,3234,152567,135480,202921,85126,1554,1370,1576,1658
2019년1분기,골목상권,삼성로69길,강남구,대치4동,356984,3460,802,184220,172762,249446,107537,1699,1761,433,369
2019년2분기,골목상권,삼성로69길,강남구,대치4동,394959,3460,1962,200534,194426,267090,127873,1699,1761,1057,905
2019년1분기,골목상권,동남로85길,강동구,고덕1동,53791,2914,150,28692,25097,39403,14383,1498,1416,63,87
2019년2분기,골목상권,동남로85길,강동구,고덕1동,76753,2914,301,39129,37626,54735,22016,1498,1416,213,88
2019년1분기,골목상권,명일로13길,강동구,둔촌2동,255507,2767,459,133626,121883,186581,68926,1379,1388,236,223
2019년2분기,골목상권,명일로13길,강동구,둔촌2동,290862,2767,261,150339,140519,210329,80533,1379,1388,159,102
2019년1분기,골목상권,상암로14길,강동구,천호2동,326925,3651,405,172278,154645,230636,96280,1791,1860,203,202
2019년2분기,골목상권,상암로14길,강동구,천호2동,370323,3651,447,194391,175933,259634,110688,1791,1860,281,166
2019년1분기,골목상권,신림로28길,관악구,서림동,317565,2973,782,183682,133882,225989,91582,1751,1222,508,274
2019년2분기,골목상권,신림로28길,관악구,서림동,317273,2973,454,181583,135688,222792,94481,1751,1222,285,169
2019년1분기,골목상권,신림로38길,관악구,서림동,131056,2009,85,72868,58188,92735,38322,1048,961,36,49
2019년2분기,골목상권,신림로38길,관악구,서림동,141804,2009,131,78033,63773,98744,43061,1048,961,78,53
2019년1분기,골목상권,신림로48길,관악구,서원동,127933,2604,72,65564,62368,87132,40799,1367,1237,36,36
2019년2분기,골목상권,신림로48길,관악구,서원동,151762,2604,82,77596,74168,101518,50246,1367,1237,51,31
2019년1분기,골목상권,서초대로23길,서초구,방배4동,237656,2408,1817,120475,117181,182672,54985,1149,1259,1017,800
2019년2분기,골목상권,서초대로23길,서초구,방배4동,295171,2408,2349,147598,147571,224750,70418,1149,1259,1375,974
2019년1분기,골목상권,서초대로25길,서초구,방배4동,198105,1261,2284,98730,99374,153594,44507,597,664,1370,914
2019년2분기,골목상권,서초대로25길,서초구,방배4동,250393,1261,2755,123313,127080,192060,58333,597,664,2175,580
2019년1분기,골목상권,서초대로4길,서초구,방배2동,250026,3519,976,119768,130256,181219,68805,1586,1933,623,353
2019년2분기,골목상권,서초대로4길,서초구,방배2동,316593,3519,890,149999,166592,226691,89902,1586,1933,520,370
2019년1분기,골목상권,삼성로75길,강남구,대치4동,395768,2533,1458,213615,182148,303667,92103,1236,1297,803,655
2019년2분기,골목상권,삼성로75길,강남구,대치4동,461279,2533,2145,247155,214124,352213,109061,1236,1297,1449,696
2019년1분기,골목상권,선릉로121길,강남구,논현2동,153528,846,2303,82682,70848,123211,30319,396,450,982,1321
2019년2분기,골목상권,선릉로121길,강남구,논현2동,186980,846,2164,98030,88950,149323,37658,396,450,1181,983
2019년1분기,골목상권,선릉로132길,강남구,청담동,194048,2042,901,93569,100480,155621,38430,937,1105,386,515
2019년2분기,골목상권,선릉로132길,강남구,청담동,416255,2042,1291,198848,217407,327281,88965,937,1105,618,673
2019년1분기,골목상권,고덕로25길,강동구,암사3동,29367,1531,143,15284,14083,20828,8538,763,768,70,73
2019년2분기,골목상권,고덕로25길,강동구,암사3동,32561,1531,286,16535,16027,22771,9791,763,768,199,87
2019년1분기,골목상권,고덕로61길,강동구,고덕1동,18511,1602,206,8154,10359,13705,4810,821,781,71,135
2019년2분기,골목상권,고덕로61길,강동구,고덕1동,29454,1602,96,13885,15569,21292,8163,821,781,57,39
2019년1분기,골목상권,구천면로36길,강동구,천호1동,149325,2602,57,78239,71088,103889,45439,1347,1255,27,30
2019년2분기,골목상권,구천면로36길,강동구,천호1동,176873,2602,45,89717,87157,121110,55765,1347,1255,22,23
2019년1분기,골목상권,구천면로41길,강동구,천호2동,279422,5439,468,142226,137191,197745,81683,2715,2724,221,247
2019년2분기,골목상권,구천면로41길,강동구,천호2동,324159,5439,400,162089,162073,225297,98867,2715,2724,206,194
2019년1분기,골목상권,신림로64길,관악구,신림동,193047,1651,280,101470,91578,136465,56582,887,764,139,141
2019년2분기,골목상권,신림로64길,관악구,신림동,230673,1651,183,117825,112847,161942,68727,887,764,90,93
2019년1분기,골목상권,신림로65길,관악구,신림동,290492,1967,115,153992,136499,192862,97629,941,1026,61,54
2019년2분기,골목상권,신림로65길,관악구,신림동,346003,1967,221,186197,159805,228662,117336,941,1026,170,51
2019년1분기,골목상권,신사로20길,관악구,신사동,130272,1872,120,63193,67078,90665,39604,952,920,79,41
2019년2분기,골목상권,신사로20길,관악구,신사동,167396,1872,115,82206,85187,114792,52608,952,920,85,30
2019년1분기,골목상권,서초대로64길,서초구,서초1동,191051,1759,1200,99868,91185,139927,51125,848,911,488,712
2019년2분기,골목상권,서초대로64길,서초구,서초1동,235547,1759,1706,119139,116407,169515,66032,848,911,1213,493
2019년1분기,골목상권,서초대로8길,서초구,방배2동,98968,1545,113,47053,51915,72709,26260,766,779,57,56
2019년2분기,골목상권,서초대로8길,서초구,방배2동,84600,1545,3044,41106,43493,59797,24809,766,779,719,2325
2019년1분기,골목상권,신반포로45길,서초구,잠원동,246069,2627,1829,136687,109384,193195,52873,1270,1357,1175,654
2019년2분기,골목상권,신반포로45길,서초구,잠원동,285621,2627,1139,154189,131433,223502,62118,1270,1357,590,549
2019년1분기,골목상권,선릉로133길,강남구,논현2동,470935,1549,1015,247326,223609,375038,95902,668,881,507,508
2019년2분기,골목상권,선릉로133길,강남구,논현2동,591041,1549,781,297310,293732,468336,122707,668,881,452,329
2019년1분기,골목상권,선릉로146길,강남구,청담동,374640,2058,1683,170276,204363,267948,106693,912,1146,769,914
2019년2분기,골목상권,선릉로146길,강남구,청담동,490695,2058,971,216031,274664,352548,138150,912,1146,480,491
2019년1분기,골목상권,선릉로18길,강남구,개포2동,77482,1733,370,39973,37510,58654,18831,865,868,186,184
2019년2분기,골목상권,선릉로18길,강남구,개포2동,118404,1733,561,56740,61664,84062,34339,865,868,420,141
2019년1분기,골목상권,구천면로42길,강동구,천호1동,308715,4286,207,152108,156606,218785,89930,2169,2117,101,106
2019년2분기,골목상권,구천면로42길,강동구,천호1동,281149,4286,280,138620,142531,196957,84192,2169,2117,93,187
2019년1분기,골목상권,동남로65길,강동구,명일2동,76233,2695,278,35913,40322,56292,19946,1318,1377,104,174
2019년2분기,골목상권,동남로65길,강동구,명일2동,102090,2695,316,48003,54089,76935,25156,1318,1377,209,107
2019년1분기,골목상권,동남로82길,강동구,고덕2동,20154,1694,128,17110,3046,17598,2558,915,779,47,81
2019년2분기,골목상권,동남로82길,강동구,고덕2동,67380,1694,125,42743,24636,50910,16465,915,779,81,44
2019년1분기,골목상권,신원로3길,관악구,신원동,181116,2830,157,91446,89672,121111,60004,1390,1440,60,97
2019년2분기,골목상권,신원로3길,관악구,신원동,204204,2830,191,102745,101461,135358,68849,1390,1440,109,82
2019년1분기,골목상권,양녕로6길,관악구,중앙동,226911,4600,128,115428,111480,157003,69905,2233,2367,63,65
2019년2분기,골목상권,양녕로6길,관악구,중앙동,274274,4600,178,138419,135855,189002,85271,2233,2367,109,69
2019년1분기,골목상권,은천로25길,관악구,성현동,125129,1485,100,60468,64660,91112,34014,726,759,51,49
2019년2분기,골목상권,은천로25길,관악구,성현동,144066,1485,62,70504,73561,102977,41090,726,759,33,29
2019년1분기,골목상권,언남길,서초구,양재2동,156871,2091,2069,88430,68444,126801,30066,1054,1037,1238,831
2019년2분기,골목상권,언남길,서초구,양재2동,182336,2091,1248,103129,79207,144827,37508,1054,1037,811,437
2019년1분기,골목상권,주흥15길,서초구,반포1동,288394,2694,986,149536,138859,210682,77718,1241,1453,642,344
2019년2분기,골목상권,주흥15길,서초구,반포1동,333134,2694,650,168377,164755,243165,89969,1241,1453,412,238
2019년1분기,골목상권,주흥길,서초구,반포1동,224770,3994,140,110810,113964,158834,65939,1942,2052,99,41
2019년2분기,골목상권,주흥길,서초구,반포1동,258744,3994,170,125960,132789,182613,76133,1942,2052,105,65
2019년1분기,골목상권,압구정로2길,강남구,신사동,221017,1001,1636,100923,120092,159870,61143,467,534,841,795
2019년2분기,골목상권,압구정로2길,강남구,신사동,282512,1001,1819,125230,157282,202423,80087,467,534,1266,553
2019년1분기,골목상권,언주로81길,강남구,역삼2동,675036,3491,10678,365296,309741,539172,135862,1735,1756,4715,5963
2019년2분기,골목상권,언주로81길,강남구,역삼2동,781413,3491,5855,421368,360052,622422,158993,1735,1756,3838,2017
2019년1분기,골목상권,영동대로112길,강남구,삼성1동,648477,2663,12892,336490,311985,521372,127106,1315,1348,9901,2991
2019년2분기,골목상권,영동대로112길,강남구,삼성1동,846680,2663,14335,417876,428805,656970,189715,1315,1348,11746,2589
2019년1분기,골목상권,영동대로65길,강남구,대치2동,148443,2065,1301,84949,63493,110426,38017,1041,1024,712,589
2019년2분기,골목상권,영동대로65길,강남구,대치2동,157136,2065,1259,89002,68134,113505,43631,1041,1024,735,524
2019년1분기,골목상권,장승배기로19길,동작구,노량진2동,131079,2448,528,67162,63915,92065,39013,1242,1206,379,149
2019년2분기,골목상권,장승배기로19길,동작구,노량진2동,146808,2448,130,72192,74615,102585,44222,1242,1206,62,68
2019년1분기,골목상권,장승배기로27길,동작구,노량진2동,358533,2335,141,190443,168091,274482,84051,1233,1102,89,52
2019년2분기,골목상권,장승배기로27길,동작구,노량진2동,371189,2335,252,200486,170703,280706,90483,1233,1102,141,111
2019년1분기,골목상권,흑석로13길,동작구,흑석동,438659,655,80,229017,209642,334025,104631,331,324,30,50
2019년2분기,골목상권,흑석로13길,동작구,흑석동,564088,655,74,287149,276941,438010,126077,331,324,30,44
2019년1분기,골목상권,인헌길,관악구,인헌동,141443,3008,71,70292,71151,100670,40775,1435,1573,43,28
2019년2분기,골목상권,인헌길,관악구,인헌동,174733,3008,108,84999,89734,122088,52644,1435,1573,63,45
2019년1분기,골목상권,장군봉1길,관악구,청룡동,335571,857,527,168294,167278,249643,85929,403,454,241,286
2019년2분기,골목상권,장군봉1길,관악구,청룡동,395736,857,355,194113,201626,293202,102535,403,454,197,158
2019년1분기,골목상권,장군봉2길,관악구,청룡동,121528,1757,290,66375,55155,85701,35828,873,884,128,162
2019년2분기,골목상권,장군봉2길,관악구,청룡동,140949,1757,210,73811,67138,98127,42824,873,884,130,80
2019년1분기,골목상권,청두곶길,서초구,방배2동,107640,3991,626,47952,59687,78659,28985,1881,2110,363,263
2019년2분기,골목상권,청두곶길,서초구,방배2동,141314,3991,1530,62755,78560,100648,40663,1881,2110,834,696
2019년1분기,골목상권,효령로23길,서초구,방배1동,254494,4664,853,131828,122670,192313,62187,2146,2518,455,398
2019년2분기,골목상권,효령로23길,서초구,방배1동,332587,4664,1743,168866,163720,251375,81209,2146,2518,1155,588
2019년1분기,골목상권,효령로31길,서초구,방배1동,114655,1842,2062,59134,55520,89294,25359,861,981,840,1222
2019년2분기,골목상권,효령로31길,서초구,방배1동,131910,1842,2618,67107,64804,102205,29710,861,981,2108,510
2019년1분기,골목상권,일원로3길,강남구,일원1동,168154,2386,475,91660,76496,121200,46956,1193,1193,203,272
2019년2분기,골목상권,일원로3길,강남구,일원1동,201794,2386,396,106367,95427,143341,58448,1193,1193,212,184
2019년1분기,골목상권,일원로9길,강남구,일원1동,542868,3439,601,259265,283601,426152,116718,1654,1785,344,257
2019년2분기,골목상권,일원로9길,강남구,일원1동,649154,3439,526,306457,342696,504760,144392,1654,1785,295,231
2019년1분기,골목상권,테헤란로81길,강남구,삼성1동,169247,415,5013,97891,71356,137483,31766,202,213,2759,2254
2019년2분기,골목상권,테헤란로81길,강남구,삼성1동,233051,415,1832,130224,102828,187403,45649,202,213,919,913
2019년1분기,골목상권,흑석로9길,동작구,흑석동,555322,2030,118,287256,268068,424341,130977,1033,997,56,62
2019년2분기,골목상권,흑석로9길,동작구,흑석동,741809,2030,85,379112,362697,573125,168682,1033,997,49,36
2019년1분기,골목상권,관악로10길,관악구,낙성대동,165058,4471,577,80931,84128,112926,52133,2220,2251,355,222
2019년2분기,골목상권,관악로10길,관악구,낙성대동,173397,4471,696,85803,87595,116818,56584,2220,2251,443,253
2019년1분기,골목상권,관악로14길,관악구,낙성대동,374391,1415,275,190852,183539,263853,110538,670,745,154,121
2019년2분기,골목상권,관악로14길,관악구,낙성대동,420971,1415,155,213964,207005,294825,126146,670,745,81,74
2019년1분기,골목상권,조원로10길,관악구,조원동,352353,1754,510,200491,151862,258929,93419,907,847,261,249
2019년2분기,골목상권,조원로10길,관악구,조원동,374150,1754,386,209234,164919,264441,109707,907,847,210,176
2019년1분기,골목상권,조원로18길,관악구,조원동,135413,1778,374,68784,66629,94644,40768,888,890,192,182
2019년2분기,골목상권,조원로18길,관악구,조원동,137633,1778,229,71461,66172,95080,42557,888,890,118,111
2019년1분기,골목상권,조원중앙로2길,관악구,조원동,311128,4364,1122,163638,147493,217026,94098,2209,2155,778,344
2019년2분기,골목상권,조원중앙로2길,관악구,조원동,366358,4364,960,189725,176634,253018,113340,2209,2155,714,246
2019년1분기,골목상권,효령로34길,서초구,방배3동,72187,1562,1100,36338,35849,56078,16113,747,815,651,449
2019년2분기,골목상권,효령로34길,서초구,방배3동,94175,1562,1303,46311,47864,74820,19355,747,815,793,510
2019년1분기,골목상권,효령로72길,서초구,서초2동,184496,2091,1200,104262,80239,143867,40634,1023,1068,804,396
2019년2분기,골목상권,효령로72길,서초구,서초2동,203909,2091,6106,116408,87501,159431,44478,1023,1068,5022,1084
2019년1분기,골목상권,방배중앙로21길,서초구,방배본동,50406,2768,508,21185,29224,34828,15575,1261,1507,316,192
2019년2분기,골목상권,방배중앙로21길,서초구,방배본동,73871,2768,7175,29028,44844,50409,23465,1261,1507,2607,4568
2019년1분기,골목상권,서초중앙로8길,서초구,서초1동,162260,2653,4963,85710,76547,127442,34813,1312,1341,3101,1862
2019년2분기,골목상권,서초중앙로8길,서초구,서초1동,192037,2653,3692,100512,91524,151116,40915,1312,1341,2516,1176
2019년1분기,골목상권,학동로38길,강남구,논현2동,400911,1519,1984,186929,213984,302717,98196,705,814,823,1161
2019년2분기,골목상권,학동로38길,강남구,논현2동,494435,1519,1947,226180,268252,371171,123263,705,814,920,1027
2019년1분기,골목상권,학동로56길,강남구,삼성2동,345404,1007,3119,174435,170967,278465,66937,465,542,1317,1802
2019년2분기,골목상권,학동로56길,강남구,삼성2동,427506,1007,2664,213233,214272,342469,85037,465,542,1762,902
2019년1분기,골목상권,학동로6길,강남구,논현1동,104421,1604,625,54163,50259,77069,27354,734,870,347,278
2019년2분기,골목상권,학동로6길,강남구,논현1동,133951,1604,1599,67431,66520,99701,34248,734,870,1065,534
2019년1분기,골목상권,관악로28길,관악구,행운동,116741,3096,190,58147,58593,84140,32600,1532,1564,63,127
2019년2분기,골목상권,관악로28길,관악구,행운동,136405,3096,127,65687,70718,96661,39741,1532,1564,37,90
2019년1분기,골목상권,관악로30길,관악구,청림동,130906,2739,240,64814,66091,92769,38137,1365,1374,89,151
2019년2분기,골목상권,관악로30길,관악구,청림동,160485,2739,94,75498,84987,112116,48368,1365,1374,13,81
2019년1분기,골목상권,관천로15길,관악구,신사동,119624,4588,220,60490,59132,82619,37010,2312,2276,138,82
2019년2분기,골목상권,관천로15길,관악구,신사동,146032,4588,224,73766,72266,98100,47932,2312,2276,150,74
2019년1분기,골목상권,중앙길,관악구,중앙동,447797,3241,157,223972,223827,312914,134891,1602,1639,49,108
2019년2분기,골목상권,중앙길,관악구,중앙동,504771,3241,85,247467,257305,349657,155119,1602,1639,24,61
2019년1분기,골목상권,청룡8길,관악구,청룡동,329690,1945,234,168762,160927,239130,90564,939,1006,96,138
2019년2분기,골목상권,청룡8길,관악구,청룡동,397180,1945,251,199259,197922,285288,111889,939,1006,75,176
2019년1분기,골목상권,청룡길,관악구,청룡동,301461,3526,471,156092,145368,212945,88512,1673,1853,291,180
2019년2분기,골목상권,청룡길,관악구,청룡동,343694,3526,318,174549,169146,241984,101712,1673,1853,205,113
2019년1분기,골목상권,강남대로118길,강남구,논현1동,148749,1463,205,77503,71243,109334,39417,630,833,104,101
2019년2분기,골목상권,강남대로118길,강남구,논현1동,182939,1463,216,94026,88912,134009,48924,630,833,97,119
2019년1분기,골목상권,강남대로136길,강남구,논현1동,138321,1263,2216,77135,61184,110285,28041,572,691,1062,1154
2019년2분기,골목상권,강남대로136길,강남구,논현1동,160787,1263,5386,85831,74956,128794,31995,572,691,3882,1504
2019년1분기,골목상권,강남대로140길,강남구,논현1동,104327,1863,1455,50405,53921,81805,22524,846,1017,762,693
2019년2분기,골목상권,강남대로140길,강남구,논현1동,135387,1863,1129,66472,68912,106790,28597,846,1017,561,568
2019년1분기,골목상권,개포로17길,강남구,개포4동,236552,3678,1134,143660,92890,182575,53972,1792,1886,679,455
2019년2분기,골목상권,개포로17길,강남구,개포4동,271769,3678,1190,153068,118705,206788,64983,1792,1886,828,362
2019년1분기,골목상권,학동로77길,강남구,청담동,248187,3038,1692,110377,137809,186510,61679,1440,1598,650,1042
2019년2분기,골목상권,학동로77길,강남구,청담동,313554,3038,2314,135990,177565,235355,78195,1440,1598,1362,952
2019년1분기,골목상권,거마로20길,송파구,마천2동,221609,3303,588,111360,110247,154623,66992,1666,1637,245,343
2019년2분기,골목상권,거마로20길,송파구,마천2동,257318,3303,514,128493,128824,178796,78519,1666,1637,245,269
2019년1분기,골목상권,동남로20길,송파구,가락2동,717720,3571,1179,356142,361576,524443,193277,1709,1862,580,599
2019년2분기,골목상권,동남로20길,송파구,가락2동,865299,3571,2640,433271,432027,634552,230751,1709,1862,1844,796
2019년1분기,골목상권,관천로22길,관악구,신림동,168011,4339,169,83741,84270,116457,51555,2127,2212,69,100
2019년2분기,골목상권,관천로22길,관악구,신림동,201312,4339,240,98496,102819,138450,62864,2127,2212,155,85
2019년1분기,골목상권,구암길,관악구,성현동,174633,2935,250,85034,89597,124856,49777,1465,1470,86,164
2019년2분기,골목상권,구암길,관악구,성현동,208008,2935,152,99339,108669,146452,61562,1465,1470,36,116
2019년1분기,골목상권,국회단지길,관악구,은천동,299403,5533,87,153668,145733,203630,95767,2762,2771,42,45
2019년2분기,골목상권,국회단지길,관악구,은천동,343051,5533,3757,170086,172965,227274,115775,2762,2771,1162,2595
2019년1분기,골목상권,청림3길,관악구,청림동,179148,4202,273,88317,90830,124814,54328,2075,2127,123,150
2019년2분기,골목상권,청림3길,관악구,청림동,205484,4202,152,100956,104531,139368,66126,2075,2127,49,103
2019년1분기,골목상권,행운1길,관악구,행운동,257014,3312,514,125084,131927,177364,79652,1668,1644,247,267
2019년2분기,골목상권,행운1길,관악구,행운동,300255,3312,228,145663,154593,207259,93003,1668,1644,132,96
2019년1분기,골목상권,행운길,관악구,행운동,373801,4876,851,182322,191479,256102,117696,2395,2481,610,241
2019년2분기,골목상권,행운길,관악구,행운동,440214,4876,575,211841,228372,301223,138990,2395,2481,450,125
2019년1분기,골목상권,개포로20길,강남구,개포4동,174403,2405,1412,104100,70302,134649,39752,1170,1235,861,551
2019년2분기,골목상권,개포로20길,강남구,개포4동,204736,2405,768,116745,87991,156655,48078,1170,1235,474,294
2019년1분기,골목상권,개포로28길,강남구,개포4동,83903,2068,863,45891,38014,64805,19100,994,1074,571,292
2019년2분기,골목상권,개포로28길,강남구,개포4동,102713,2068,584,54335,48376,77127,25590,994,1074,439,145
2019년1분기,골목상권,개포로82길,강남구,개포2동,27239,28,195,13662,13577,20505,6735,18,10,98,97
2019년2분기,골목상권,개포로82길,강남구,개포2동,35895,28,94,16892,19003,26066,9828,18,10,54,40
2019년1분기,골목상권,마천로51길,송파구,마천2동,188207,3999,421,96013,92192,129820,58390,2059,1940,253,168
2019년2분기,골목상권,마천로51길,송파구,마천2동,222296,3999,379,111940,110356,152687,69608,2059,1940,213,166
2019년1분기,골목상권,백제고분로21길,송파구,삼전동,331107,2499,547,161919,169190,238273,92836,1241,1258,303,244
2019년2분기,골목상권,백제고분로21길,송파구,삼전동,407841,2499,461,195237,212606,288276,119562,1241,1258,293,168
2019년1분기,골목상권,백제고분로22길,송파구,삼전동,255775,6884,1019,129656,126119,181870,73904,3301,3583,576,443
2019년2분기,골목상권,백제고분로22길,송파구,삼전동,314297,6884,928,160861,153438,220734,93568,3301,3583,601,327
2019년1분기,골목상권,낙성대역길,관악구,인헌동,592422,5278,162,316933,275489,420493,171930,2608,2670,89,73
2019년2분기,골목상권,낙성대역길,관악구,인헌동,677647,5278,493,355488,322160,479278,198369,2608,2670,282,211
2019년1분기,골목상권,난곡로24길,관악구,난곡동,39686,2463,74,22075,17612,26081,13604,1296,1167,22,52
2019년2분기,골목상권,난곡로24길,관악구,난곡동,52506,2463,89,25075,27431,34335,18170,1296,1167,42,47
2019년1분기,골목상권,난곡로26길,관악구,난곡동,100770,3307,95,53301,47473,68203,32563,1680,1627,42,53
2019년2분기,골목상권,난곡로26길,관악구,난곡동,122266,3307,108,64328,57940,81857,40415,1680,1627,77,31
2019년1분기,골목상권,난곡로34길,관악구,난곡동,189495,2567,132,97805,91691,135209,54292,1303,1264,48,84
2019년2분기,골목상권,난곡로34길,관악구,난곡동,217929,2567,61,110323,107609,153337,64592,1303,1264,26,35
2019년1분기,골목상권,호암로20길,관악구,대학동,344383,3095,89,218124,126259,243798,100590,1978,1117,42,47
2019년2분기,골목상권,호암로20길,관악구,대학동,423318,3095,207,265156,158162,298280,125028,1978,1117,89,118
2019년1분기,골목상권,호암로24길,관악구,대학동,818134,2712,775,493408,324728,586348,231776,1682,1030,346,429
2019년2분기,골목상권,호암로24길,관악구,대학동,945902,2712,1199,561833,384068,667956,277947,1682,1030,1059,140
2019년1분기,골목상권,양산길,관악구,삼성동,116664,1578,64,64260,52403,83715,32950,809,769,25,39
2019년2분기,골목상권,양산길,관악구,삼성동,140573,1578,7,77856,62719,99238,41336,809,769,2,5
2019년1분기,골목상권,남부순환로365길,강남구,도곡1동,153317,2859,616,76421,76897,104096,49220,1378,1481,389,227
2019년2분기,골목상권,남부순환로365길,강남구,도곡1동,194366,2859,714,99070,95292,135766,58596,1378,1481,454,260
2019년1분기,골목상권,논현로106길,강남구,역삼1동,258819,2107,1094,130633,128187,197604,61217,924,1183,678,416
2019년2분기,골목상권,논현로106길,강남구,역삼1동,377542,2107,1458,188641,188897,296528,81014,924,1183,1011,447
2019년1분기,골목상권,논현로10길,강남구,개포4동,157917,1575,1262,87287,70631,120983,36940,786,789,765,497
2019년2분기,골목상권,논현로10길,강남구,개포4동,201330,1575,581,111220,90108,152156,49171,786,789,343,238
2019년1분기,골목상권,백제고분로31길,송파구,삼전동,349422,6266,1977,171402,178019,244835,104587,2886,3380,1404,573
2019년2분기,골목상권,백제고분로31길,송파구,삼전동,553268,6266,1747,265628,287644,383785,169486,2886,3380,1347,400
2019년1분기,골목상권,백제고분로32길,송파구,삼전동,161932,6454,778,84212,77719,115932,45995,3067,3387,520,258
2019년2분기,골목상권,백제고분로32길,송파구,삼전동,214842,6454,710,108830,106014,153036,61803,3067,3387,423,287
2019년1분기,골목상권,백제고분로33길,송파구,석촌동,317253,6311,1395,166333,150920,218689,98561,2980,3331,525,870
2019년2분기,골목상권,백제고분로33길,송파구,석촌동,496499,6311,1138,253377,243121,338963,157536,2980,3331,741,397
2019년1분기,골목상권,난곡로74길,관악구,신사동,331823,1853,105,175322,156501,228266,103564,871,982,37,68
2019년2분기,골목상권,난곡로74길,관악구,신사동,406895,1853,2071,213424,193471,276766,130129,871,982,1671,400
2019년1분기,골목상권,난우길,관악구,미성동,178315,2409,304,86682,91635,127515,50806,1190,1219,165,139
2019년2분기,골목상권,난우길,관악구,미성동,216053,2409,181,104287,111764,151479,64575,1190,1219,95,86
2019년1분기,골목상권,난향길,관악구,난향동,46824,2621,183,24638,22184,33755,13068,1375,1246,55,128
2019년2분기,골목상권,난향길,관악구,난향동,60627,2621,694,31429,29199,42364,18263,1375,1246,279,415
2019년1분기,골목상권,양지길,관악구,삼성동,94756,1787,14,53259,41497,67543,27212,894,893,8,6
2019년2분기,골목상권,양지길,관악구,삼성동,116806,1787,10,65175,51635,81022,35785,894,893,2,8
2019년1분기,골목상권,원신길,관악구,삼성동,36995,1352,109,18661,18332,25858,11135,684,668,44,65
2019년2분기,골목상권,원신길,관악구,삼성동,88699,1352,39,51458,37242,61979,26724,684,668,15,24
2019년1분기,골목상권,소담길,관악구,청룡동,126854,709,72,68329,58526,89647,37204,385,324,23,49
2019년2분기,골목상권,소담길,관악구,청룡동,148393,709,15,80119,68275,100901,47489,385,324,4,11
2019년1분기,골목상권,강남대로23길,서초구,양재1동,94187,1101,2739,58122,36067,77998,16192,545,556,1882,857
2019년2분기,골목상권,강남대로23길,서초구,양재1동,126258,1101,2345,75219,51039,102104,24158,545,556,1776,569
2019년1분기,골목상권,논현로115길,강남구,논현1동,405825,3224,1176,217072,188755,300788,105043,1527,1697,658,518
2019년2분기,골목상권,논현로115길,강남구,논현1동,437443,3224,2392,223135,214309,328108,109338,1527,1697,1454,938
2019년1분기,골목상권,논현로123길,강남구,논현1동,64463,2084,333,35367,29097,47977,16487,990,1094,192,141
2019년2분기,골목상권,논현로123길,강남구,논현1동,83719,2084,203,44346,39374,62106,21614,990,1094,122,81
2019년1분기,골목상권,논현로139길,강남구,논현1동,174363,1378,3912,93722,80640,140125,34244,655,723,1986,1926
2019년2분기,골목상권,논현로139길,강남구,논현1동,212506,1378,3993,113151,99356,171074,41432,655,723,2346,1647
2019년1분기,골목상권,논현로159길,강남구,신사동,70507,423,450,30847,39660,51700,18807,186,237,167,283
2019년2분기,골목상권,논현로159길,강남구,신사동,78084,423,368,35832,42251,56667,21415,186,237,126,242
2019년1분기,골목상권,백제고분로34길,송파구,석촌동,211404,7777,845,110921,100486,149876,61527,3812,3965,530,315
2019년2분기,골목상권,백제고분로34길,송파구,석촌동,309310,7777,1857,155949,153362,216977,92333,3812,3965,1347,510
2019년1분기,골목상권,백제고분로39길,송파구,석촌동,215071,3380,685,107373,107697,150849,64227,1551,1829,373,312
2019년2분기,골목상권,백제고분로39길,송파구,석촌동,272651,3380,1288,133487,139163,186076,86574,1551,1829,837,451
2019년1분기,골목상권,백제고분로42길,송파구,송파1동,226480,4194,359,106610,119871,167546,58934,2011,2183,208,151
2019년2분기,골목상권,백제고분로42길,송파구,송파1동,277194,4194,631,127471,149722,201918,75275,2011,2183,320,311
2019년1분기,골목상권,남부순환로142길,관악구,미성동,111129,3445,415,54640,56488,77565,33568,1702,1743,187,228
2019년2분기,골목상권,남부순환로142길,관악구,미성동,136616,3445,450,67530,69083,93986,42628,1702,1743,251,199
2019년1분기,골목상권,남부순환로151길,관악구,신사동,487843,3382,488,259884,227962,340966,146879,1677,1705,212,276
2019년2분기,골목상권,남부순환로151길,관악구,신사동,575372,3382,371,306354,269017,399142,176237,1677,1705,154,217
2019년1분기,골목상권,남부순환로161길,관악구,신사동,107286,3899,551,54463,52826,74831,32458,1968,1931,235,316
2019년2분기,골목상권,남부순환로161길,관악구,신사동,124534,3899,439,61523,63013,85715,38818,1968,1931,287,152
2019년1분기,골목상권,강남대로34길,서초구,양재1동,154632,2613,1774,95155,59476,118335,36298,1245,1368,1234,540
2019년2분기,골목상권,강남대로34길,서초구,양재1동,183589,2613,2194,110399,73190,139524,44066,1245,1368,1522,672
2019년1분기,골목상권,강남대로8길,서초구,양재2동,359835,3665,2349,217545,142296,276940,82894,1843,1822,1567,782
2019년2분기,골목상권,강남대로8길,서초구,양재2동,447939,3665,2001,267276,180666,340241,107700,1843,1822,1329,672
2019년1분기,골목상권,고무래로8길,서초구,반포4동,343848,1968,3715,164067,179782,260027,83814,925,1043,1907,1808
2019년2분기,골목상권,고무래로8길,서초구,반포4동,391826,1968,5772,182183,209640,291163,100658,925,1043,3607,2165
2019년1분기,골목상권,논현로26길,강남구,도곡2동,172858,1247,5802,93162,79698,134740,38119,570,677,3219,2583
2019년2분기,골목상권,논현로26길,강남구,도곡2동,229411,1247,16339,120574,108843,175739,53668,570,677,4308,12031
2019년1분기,골목상권,논현로28길,강남구,도곡2동,76528,77,1579,41485,35043,60006,16521,46,31,905,674
2019년2분기,골목상권,논현로28길,강남구,도곡2동,98462,77,3338,51786,46674,76187,22277,46,31,2289,1049
2019년1분기,골목상권,논현로63길,강남구,역삼1동,186201,2571,1757,105349,80848,144953,41247,1243,1328,1061,696
2019년2분기,골목상권,논현로63길,강남구,역삼1동,226929,2571,2108,122738,104190,175694,51234,1243,1328,1433,675
2019년1분기,골목상권,백제고분로45길,송파구,송파1동,265453,4794,999,119458,145993,177648,87801,2292,2502,627,372
2019년2분기,골목상권,백제고분로45길,송파구,송파1동,452691,4794,1150,198283,254402,296894,155794,2292,2502,713,437
2019년1분기,골목상권,백제고분로46길,송파구,송파1동,277026,3217,642,136508,140518,201191,75829,1520,1697,357,285
2019년2분기,골목상권,백제고분로46길,송파구,송파1동,275485,3217,677,132817,142669,196134,79358,1520,1697,475,202
2019년1분기,골목상권,백제고분로50길,송파구,방이2동,296957,8436,759,151362,145593,208708,88253,4124,4312,472,287
2019년2분기,골목상권,백제고분로50길,송파구,방이2동,377308,8436,1354,185477,191828,257027,120280,4124,4312,867,487
2019년1분기,골목상권,남부순환로172길,관악구,미성동,158151,2670,732,84618,73536,110689,47468,1327,1343,344,388
2019년2분기,골목상권,남부순환로172길,관악구,미성동,202198,2670,746,106650,95549,139070,63125,1327,1343,465,281
2019년1분기,골목상권,남부순환로234길,관악구,낙성대동,237073,1832,297,123639,113438,161204,75873,920,912,109,188
2019년2분기,골목상권,남부순환로234길,관악구,낙성대동,283303,1832,183,146043,137260,192943,90359,920,912,118,65
2019년1분기,골목상권,남부순환로248길,관악구,인헌동,87484,1646,431,40836,46648,60906,26584,769,877,195,236
2019년2분기,골목상권,남부순환로248길,관악구,인헌동,106983,1646,484,49478,57505,73335,33651,769,877,255,229
2019년1분기,골목상권,남부순환로317길,서초구,서초3동,254654,1741,3467,128523,126128,191599,63059,848,893,2349,1118
2019년2분기,골목상권,남부순환로317길,서초구,서초3동,297358,1741,2256,149672,147685,222588,74773,848,893,1460,796
2019년1분기,골목상권,남부순환로325길,서초구,서초3동,454976,2444,1320,230311,224664,343491,111485,1203,1241,698,622
2019년2분기,골목상권,남부순환로325길,서초구,서초3동,518097,2444,1658,260863,257236,392837,125262,1203,1241,956,702
2019년1분기,골목상권,남부순환로339길,서초구,서초1동,129901,1541,11681,78474,51429,107364,22538,764,777,5256,6425
2019년2분기,골목상권,남부순환로339길,서초구,서초1동,157528,1541,2908,91975,65555,129129,28396,764,777,1282,1626
2019년1분기,골목상권,논현로8길,강남구,개포4동,94288,3622,1227,49762,44524,74434,19852,1776,1846,821,406
2019년2분기,골목상권,논현로8길,강남구,개포4동,122302,3622,886,64047,58255,91854,30448,1776,1846,597,289
2019년1분기,골목상권,도곡로37길,강남구,역삼2동,399955,6062,4932,199186,200766,313060,86902,2806,3256,3048,1884
2019년2분기,골목상권,도곡로37길,강남구,역삼2동,487498,6062,7533,236932,250564,380867,106622,2806,3256,4630,2903
2019년1분기,골목상권,도산대로15길,강남구,신사동,69375,694,430,31580,37795,51456,17920,309,385,191,239
2019년2분기,골목상권,도산대로15길,강남구,신사동,89517,694,292,41465,48052,65958,23557,309,385,167,125
2019년1분기,골목상권,도산대로23길,강남구,신사동,229043,1506,617,121519,107526,182120,46924,661,845,358,259
2019년2분기,골목상권,도산대로23길,강남구,신사동,284134,1506,606,151994,132136,224977,59154,661,845,253,353
2019년1분기,골목상권,삼전로13길,송파구,잠실본동,398026,6562,1347,195813,202213,285534,112492,3101,3461,638,709
2019년2분기,골목상권,삼전로13길,송파구,잠실본동,507675,6562,1272,247191,260484,359353,148331,3101,3461,791,481
2019년1분기,골목상권,송이로23길,송파구,가락2동,181052,4454,1818,94071,86981,135606,45447,2183,2271,993,825
2019년2분기,골목상권,송이로23길,송파구,가락2동,207983,4454,1776,103062,104920,154227,53760,2183,2271,1262,514
2019년1분기,골목상권,송이로32길,송파구,문정1동,317707,5600,1043,162454,155248,234744,82964,2803,2797,527,516
2019년2분기,골목상권,송이로32길,송파구,문정1동,393220,5600,1336,192155,201065,283814,109408,2803,2797,801,535
2019년1분기,골목상권,남현2길,관악구,남현동,170859,2797,1320,89306,81552,122149,48714,1324,1473,684,636
2019년2분기,골목상권,남현2길,관악구,남현동,201745,2797,931,103116,98630,144199,57545,1324,1473,661,270
2019년1분기,골목상권,남현3길,관악구,남현동,457477,1610,241,243969,213507,324243,133236,750,860,102,139
2019년2분기,골목상권,남현3길,관악구,남현동,521778,1610,466,274783,246996,370280,151497,750,860,315,151
2019년1분기,골목상권,남현길,관악구,남현동,156683,1976,81,79614,77069,107327,49360,922,1054,29,52
2019년2분기,골목상권,남현길,관악구,남현동,192769,1976,143,91436,101333,130349,62420,922,1054,43,100
2019년1분기,골목상권,논현로1길,서초구,양재2동,81327,3209,1537,44786,36541,61437,19885,1549,1660,893,644
2019년2분기,골목상권,논현로1길,서초구,양재2동,106768,3209,1592,58679,48086,78748,28014,1549,1660,1121,471
2019년1분기,골목상권,논현로27길,서초구,양재1동,182434,1813,2566,106691,75741,149342,33086,866,947,1675,891
2019년2분기,골목상권,논현로27길,서초구,양재1동,246095,1813,2976,138423,107671,196994,49098,866,947,2165,811
2019년1분기,골목상권,동광로12길,서초구,방배4동,199732,1371,1171,99903,99832,141335,58396,630,741,582,589
2019년2분기,골목상권,동광로12길,서초구,방배4동,241111,1371,873,118574,122536,167857,73254,630,741,489,384
2019년1분기,전통시장,동서울시장,강동구,천호2동,36468,180,10,20185,16283,23462,13007,89,91,5,5
2019년2분기,전통시장,동서울시장,강동구,천호2동,37499,180,10,19865,17633,23599,13900,89,91,5,5
2019년1분기,전통시장,천호시장,강동구,천호2동,130658,139,99,72451,58207,84051,46606,71,68,56,43
2019년2분기,전통시장,천호시장,강동구,천호2동,135553,139,32,71451,64103,85748,49805,71,68,20,12
2019년1분기,전통시장,성내골목시장,강동구,성내2동,90355,954,48,44103,46253,64379,25977,498,456,23,25
2019년2분기,전통시장,성내골목시장,강동구,성내2동,106568,954,35,50990,55576,73739,32834,498,456,20,15
2019년1분기,전통시장,영등포청과시장,영등포구,당산1동,30612,287,185,16718,13894,21901,8710,155,132,118,67
2019년2분기,전통시장,영등포청과시장,영등포구,당산1동,36700,287,30,20080,16620,25911,10791,155,132,21,9
2019년1분기,전통시장,도림시장,영등포구,도림동,11544,67,44,5856,5689,7854,3690,32,35,29,15
2019년2분기,전통시장,도림시장,영등포구,도림동,14065,67,7,7280,6785,9510,4555,32,35,5,2
2019년1분기,전통시장,영일시장,영등포구,문래동,99539,721,222,50771,48769,65604,33935,373,348,151,71
2019년2분기,전통시장,영일시장,영등포구,문래동,120691,721,174,62603,58088,78676,42013,373,348,128,46
2019년1분기,전통시장,둔촌역전통시장,강동구,성내3동,117179,613,1365,62462,54717,84936,32245,311,302,852,513
2019년2분기,전통시장,둔촌역전통시장,강동구,성내3동,124179,613,188,64572,59605,89139,35040,311,302,104,84
2019년1분기,전통시장,길동복조리시장,강동구,길동,206428,3178,965,104505,101924,146990,59438,1582,1596,485,480
2019년2분기,전통시장,길동복조리시장,강동구,길동,220748,3178,431,108957,111792,156177,64574,1582,1596,268,163
2019년1분기,관광특구,이태원 관광특구,용산구,이태원1동,1832223,5396,8383,950326,881901,1093760,738451,2573,2823,4582,3801
2019년2분기,관광특구,이태원 관광특구,용산구,이태원1동,2346735,5396,5797,1201542,1145199,1369128,977606,2573,2823,3200,2597
2019년1분기,전통시장,대신시장,영등포구,신길1동,61069,107,40,30009,31061,45312,15758,51,56,22,18
2019년2분기,전통시장,대신시장,영등포구,신길1동,74922,107,39,38246,36676,55559,19363,51,56,23,16
2019년1분기,전통시장,사러가시장,영등포구,신길3동,84430,91,173,42721,41708,60356,24075,40,51,92,81
2019년2분기,전통시장,사러가시장,영등포구,신길3동,91560,91,83,46108,45451,65075,26484,40,51,44,39
2019년1분기,전통시장,영진시장A동,영등포구,신길6동,60727,123,27,31381,29346,42915,17812,60,63,16,11
2019년2분기,전통시장,영진시장A동,영등포구,신길6동,47103,123,27,24197,22907,32530,14572,60,63,16,11
2019년1분기,관광특구,명동 남대문 북창동 다동 무교동 관광특구,중구,소공동,4615196,1118,174313,2285088,2330105,3715058,900139,404,714,82227,92086
2019년2분기,관광특구,명동 남대문 북창동 다동 무교동 관광특구,중구,소공동,5674813,1118,133878,2729602,2945208,4540677,1134139,404,714,65609,68269
2019년1분기,관광특구,동대문패션타운 관광특구,중구,광희동,2544968,2012,20637,1283363,1261604,2005593,539368,1008,1004,11058,9579
2019년2분기,관광특구,동대문패션타운 관광특구,중구,광희동,3253857,2012,6683,1614002,1639849,2550061,703785,1008,1004,3404,3279
2019년1분기,관광특구,종로?청계 관광특구,종로구,종로1.2.3.4가동,4267140,1930,38037,2360635,1906505,3246720,1020423,1293,637,24023,14014
2019년2분기,관광특구,종로?청계 관광특구,종로구,종로1.2.3.4가동,4948139,1930,24700,2691290,2256844,3765744,1182390,1293,637,16394,8306
2019년1분기,전통시장,우리시장,영등포구,대림1동,7932,333,37,3105,4824,5205,2727,164,169,29,8
2019년2분기,전통시장,우리시장,영등포구,대림1동,18657,333,11,8536,10123,12427,6233,164,169,10,1
2019년1분기,전통시장,대림중앙시장,영등포구,대림2동,39250,402,20,20059,19193,25644,13606,197,205,13,7
2019년2분기,전통시장,대림중앙시장,영등포구,대림2동,44516,402,41,22845,21672,28255,16263,197,205,29,12
2019년1분기,전통시장,노량진중앙시장,동작구,노량진1동,208395,165,304,125388,83007,148402,59991,100,65,156,148
2019년2분기,전통시장,노량진중앙시장,동작구,노량진1동,250269,165,181,145713,104556,166462,83810,100,65,104,77
2019년1분기,전통시장,본동인정시장,동작구,노량진1동,67374,442,64,35753,31622,47625,19748,241,201,33,31
2019년2분기,전통시장,본동인정시장,동작구,노량진1동,75699,442,67,40437,35263,52541,23157,241,201,45,22
2019년1분기,관광특구,잠실 관광특구,송파구,오륜동,1894478,7083,23104,1000145,894324,1353318,541152,3291,3792,13243,9861
2019년2분기,관광특구,잠실 관광특구,송파구,오륜동,2416523,7083,26843,1246768,1169758,1682431,734096,3291,3792,16958,9885
2019년1분기,관광특구,강남 마이스 관광특구,강남구,삼성1동,50225,26,26319,25311,24913,38576,11648,17,9,15076,11243
2019년2분기,관광특구,강남 마이스 관광특구,강남구,삼성1동,79398,26,18430,39454,39944,59916,19482,17,9,10279,8151
2019년1분기,전통시장,신노량진시장,동작구,노량진2동,17353,16,26,7495,9857,11942,5410,8,8,10,16
2019년2분기,전통시장,신노량진시장,동작구,노량진2동,17826,16,5,7467,10359,12306,5520,8,8,1,4
2019년1분기,전통시장,강남시장_동작,동작구,상도1동,32572,120,20,16350,16222,24761,7811,46,74,9,11
2019년2분기,전통시장,강남시장_동작,동작구,상도1동,48904,120,1,25216,23688,37806,11099,46,74,0,1
2019년1분기,전통시장,상도전통시장,동작구,상도1동,114876,1623,309,57250,57625,81257,33617,780,843,187,122
2019년2분기,전통시장,상도전통시장,동작구,상도1동,126329,1623,235,62332,64000,87077,39248,780,843,115,120
2019년1분기,전통시장,영도시장,동작구,상도2동,45718,56,117,22518,23200,34400,11318,26,30,25,92
2019년2분기,전통시장,영도시장,동작구,상도2동,59948,56,72,28398,31550,44507,15441,26,30,6,66
2019년1분기,전통시장,성대시장,동작구,상도3동,37976,178,238,18433,19544,27196,10781,84,94,99,139
2019년2분기,전통시장,성대시장,동작구,상도3동,41963,178,147,20489,21473,29445,12518,84,94,60,87
2019년1분기,전통시장,상도4동도깨비골목시장,동작구,상도4동,112771,1920,93,56027,56745,78193,34579,939,981,34,59
2019년2분기,전통시장,상도4동도깨비골목시장,동작구,상도4동,128945,1920,100,63205,65740,88203,40742,939,981,37,63
2019년1분기,전통시장,흑석시장,동작구,흑석동,617788,1055,204,301986,315800,484663,133126,492,563,84,120
2019년2분기,전통시장,흑석시장,동작구,흑석동,791020,1055,87,381732,409287,626868,164150,492,563,35,52
2019년1분기,전통시장,남성사계시장,동작구,사당2동,203395,572,404,102261,101134,147798,55596,275,297,183,221
2019년2분기,전통시장,남성사계시장,동작구,사당2동,247586,572,124,120061,127526,179196,68387,275,297,56,68
2019년1분기,전통시장,남성역골목시장,동작구,사당4동,398605,563,261,201275,197331,287585,111024,240,323,109,152
2019년2분기,전통시장,남성역골목시장,동작구,사당4동,475053,563,490,234399,240655,340987,134066,240,323,271,219
2019년1분기,전통시장,사당시장,동작구,사당4동,71094,7,194,35963,35132,50879,20216,4,3,65,129
2019년2분기,전통시장,사당시장,동작구,사당4동,84089,7,73,41570,42520,59869,24220,4,3,37,36
2019년1분기,전통시장,중부시장,관악구,행운동,92965,649,288,44829,48136,66454,26510,301,348,98,190
2019년2분기,전통시장,중부시장,관악구,행운동,116797,649,85,54731,62068,83262,33536,301,348,33,52
2019년1분기,전통시장,낙성대시장,관악구,낙성대동,81509,613,95,41273,40236,57175,24333,289,324,69,26
2019년2분기,전통시장,낙성대시장,관악구,낙성대동,89163,613,24,44822,44341,62710,26453,289,324,14,10
2019년1분기,전통시장,봉천제일종합시장,관악구,청룡동,24694,427,31,12490,12203,17639,7055,192,235,15,16
2019년2분기,전통시장,봉천제일종합시장,관악구,청룡동,30315,427,6,15045,15269,21522,8794,192,235,1,5
2019년1분기,전통시장,봉일시장,관악구,은천동,53187,100,109,29033,24154,39046,14139,50,50,50,59
2019년2분기,전통시장,봉일시장,관악구,은천동,50008,100,49,26661,23346,36259,13748,50,50,24,25
2019년1분기,전통시장,신월6동골목시장,양천구,신월6동,56095,168,331,30071,26023,41382,14717,93,75,176,155
2019년2분기,전통시장,신월6동골목시장,양천구,신월6동,65902,168,184,35498,30403,47981,17924,93,75,116,68
2019년1분기,전통시장,신월7동골목시장,양천구,신월7동,19035,127,123,10823,8212,13590,5445,61,66,49,74
2019년2분기,전통시장,신월7동골목시장,양천구,신월7동,24122,127,43,13621,10501,17040,7084,61,66,22,21
2019년1분기,전통시장,신정제일시장,양천구,신정1동,15206,169,71,7831,7375,10948,4258,71,98,22,49
2019년2분기,전통시장,신정제일시장,양천구,신정1동,17227,169,27,8869,8358,12300,4927,71,98,8,19
2019년1분기,전통시장,신정2동골목시장,양천구,신정2동,32390,473,19,16456,15934,21997,10392,235,238,8,11
2019년2분기,전통시장,신정2동골목시장,양천구,신정2동,38698,473,45,18985,19715,25712,12989,235,238,10,35
2019년1분기,전통시장,봉천현대시장,관악구,은천동,19024,13,65,8619,10405,13997,5027,5,8,31,34
2019년2분기,전통시장,봉천현대시장,관악구,은천동,23101,13,5,10278,12823,16457,6644,5,8,2,3
2019년1분기,전통시장,봉천중앙시장,관악구,중앙동,13688,449,150,6782,6906,9540,4149,214,235,60,90
2019년2분기,전통시장,봉천중앙시장,관악구,중앙동,17541,449,178,8450,9090,12355,5186,214,235,53,125
2019년1분기,전통시장,인헌시장,관악구,인헌동,129683,1476,306,62418,67265,92250,37433,720,756,114,192
2019년2분기,전통시장,인헌시장,관악구,인헌동,154637,1476,131,74206,80431,109527,45109,720,756,47,84
2019년1분기,전통시장,신정3동골목시장,양천구,신정3동,100324,263,300,55460,44863,72293,28029,161,102,178,122
2019년2분기,전통시장,신정3동골목시장,양천구,신정3동,119883,263,111,64531,55352,85547,34337,161,102,72,39
2019년1분기,전통시장,등마루시장,강서구,등촌1동,12034,4,10,5580,6454,7911,4122,3,1,6,4
2019년2분기,전통시장,등마루시장,강서구,등촌1동,12215,4,3,5649,6566,7781,4435,3,1,3,0
2019년1분기,전통시장,신월중앙시장,강서구,등촌3동,10205,70,217,5351,4854,7380,2826,40,30,92,125
2019년2분기,전통시장,신월중앙시장,강서구,등촌3동,12107,70,118,6075,6032,8595,3513,40,30,53,65
2019년1분기,전통시장,신원시장,관악구,신원동,517589,418,145,275206,242384,346062,171529,243,175,39,106
2019년2분기,전통시장,신원시장,관악구,신원동,638526,418,38,334597,303927,424249,214281,243,175,15,23
2019년1분기,전통시장,관악신사시장,관악구,신사동,82537,2249,126,38719,43819,55611,26927,1123,1126,60,66
2019년2분기,전통시장,관악신사시장,관악구,신사동,96845,2249,148,45986,50860,64848,31993,1123,1126,89,59
2019년1분기,전통시장,신림종합시장,관악구,신사동,16516,3,48,8071,8445,11664,4852,2,1,29,19
2019년2분기,전통시장,신림종합시장,관악구,신사동,18958,3,6,9454,9504,13244,5715,2,1,5,1
2019년1분기,전통시장,강남골목시장,관악구,조원동,214365,587,67,120216,94151,158282,56086,304,283,33,34
2019년2분기,전통시장,강남골목시장,관악구,조원동,219084,587,197,119063,100023,152697,66389,304,283,118,79
2019년1분기,전통시장,화곡중앙골목시장,강서구,화곡1동,98908,1056,91,46573,52335,70930,27976,514,542,31,60
2019년2분기,전통시장,화곡중앙골목시장,강서구,화곡1동,126322,1056,138,57109,69214,90039,36282,514,542,68,70
2019년1분기,전통시장,남부골목시장,강서구,화곡4동,106982,1877,253,50451,56532,74852,32129,904,973,109,144
2019년2분기,전통시장,남부골목시장,강서구,화곡4동,130354,1877,124,58657,71697,89267,41090,904,973,41,83
2019년1분기,전통시장,화곡본동시장,강서구,화곡본동,95179,353,158,46267,48914,67406,27774,158,195,66,92
2019년2분기,전통시장,화곡본동시장,강서구,화곡본동,112077,353,50,54072,58005,79836,32242,158,195,21,29
2019년1분기,전통시장,신림중앙시장,관악구,조원동,15099,53,65,7518,7582,10614,4484,31,22,40,25
2019년2분기,전통시장,신림중앙시장,관악구,조원동,15835,53,42,8018,7817,11035,4800,31,22,24,18
2019년1분기,전통시장,삼성동시장,관악구,삼성동,140197,174,16,78872,61326,100165,40033,105,69,7,9
2019년2분기,전통시장,삼성동시장,관악구,삼성동,165972,174,16,92647,73324,115830,50139,105,69,7,9
2019년1분기,전통시장,신신림시장,관악구,삼성동,19786,49,36,11262,8524,14152,5635,22,27,18,18
2019년2분기,전통시장,신신림시장,관악구,삼성동,23144,49,1,12913,10231,16109,7034,22,27,1,0
2019년1분기,전통시장,미성동도깨비시장,관악구,미성동,30624,649,112,17585,13039,21334,9288,305,344,34,78
2019년2분기,전통시장,미성동도깨비시장,관악구,미성동,42206,649,92,23208,18997,28716,13489,305,344,27,65
2019년1분기,전통시장,까치산시장,강서구,화곡8동,469680,1150,510,221735,247946,346255,123427,530,620,129,381
2019년2분기,전통시장,까치산시장,강서구,화곡8동,534543,1150,121,243181,291360,390442,144095,530,620,37,84
2019년1분기,전통시장,송화골목시장,강서구,발산1동,85923,522,320,39291,46633,63714,22210,257,265,123,197
2019년2분기,전통시장,송화골목시장,강서구,발산1동,100155,522,127,42978,57179,72734,27423,257,265,44,83
2019년1분기,전통시장,방신전통시장,강서구,방화1동,67616,588,490,36882,30733,48972,18643,291,297,251,239
2019년2분기,전통시장,방신전통시장,강서구,방화1동,59706,588,94,31542,28162,41681,18024,291,297,61,33
2019년1분기,전통시장,우림시장,관악구,난곡동,9668,75,55,5014,4654,6541,3127,32,43,33,22
2019년2분기,전통시장,우림시장,관악구,난곡동,10719,75,55,5499,5221,7083,3636,32,43,33,22
2019년1분기,전통시장,남부종합시장,서초구,방배본동,12840,177,47,7008,5831,9342,3497,86,91,30,17
2019년2분기,전통시장,남부종합시장,서초구,방배본동,15376,177,69,7972,7404,10941,4435,86,91,50,19
2019년1분기,전통시장,양재시장,서초구,양재1동,25847,94,135,15776,10071,19662,6185,54,40,73,62
2019년2분기,전통시장,양재시장,서초구,양재1동,29964,94,36,18059,11905,22720,7243,54,40,23,13
2019년1분기,전통시장,강남시장_강남,강남구,신사동,70571,287,81,37206,33365,53020,17551,131,156,38,43
2019년2분기,전통시장,강남시장_강남,강남구,신사동,84539,287,60,43218,41321,62793,21747,131,156,39,21
2019년1분기,전통시장,공항시장,강서구,방화2동,64100,172,20,36211,27890,46424,17678,80,92,13,7
2019년2분기,전통시장,공항시장,강서구,방화2동,76324,172,5,43236,33088,55033,21291,80,92,4,1
2019년1분기,전통시장,구로시장,구로구,구로4동,29134,123,16,16503,12632,23318,5817,64,59,5,11
2019년2분기,전통시장,구로시장,구로구,구로4동,43199,123,15,24230,18969,34616,8583,64,59,9,6
2019년1분기,전통시장,남구로시장,구로구,구로4동,184856,657,438,94993,89867,135080,49779,364,293,225,213
2019년2분기,전통시장,남구로시장,구로구,구로4동,222459,657,73,115121,107337,161016,61445,364,293,24,49
2019년1분기,전통시장,가리봉시장,구로구,가리봉동,36648,256,26,23611,13037,27393,9253,133,123,17,9
2019년2분기,전통시장,가리봉시장,구로구,가리봉동,49829,256,1,31491,18337,37566,12262,133,123,1,0
2019년1분기,전통시장,영동전통시장,강남구,논현1동,265354,1171,532,151628,113727,194301,71053,547,624,308,224
2019년2분기,전통시장,영동전통시장,강남구,논현1동,326847,1171,255,182043,144804,240517,86331,547,624,106,149
2019년1분기,전통시장,논현종합시장,강남구,논현2동,22151,85,164,12605,9547,17003,5148,38,47,103,61
2019년2분기,전통시장,논현종합시장,강남구,논현2동,25446,85,83,14184,11261,19351,6095,38,47,41,42
2019년1분기,전통시장,청담삼익시장,강남구,청담동,18676,167,133,9523,9153,13974,4702,82,85,66,67
2019년2분기,전통시장,청담삼익시장,강남구,청담동,23154,167,60,11679,11475,16934,6220,82,85,37,23
2019년1분기,전통시장,고척근린시장,구로구,고척2동,56978,611,162,30536,26443,40085,16891,303,308,61,101
2019년2분기,전통시장,고척근린시장,구로구,고척2동,72301,611,60,37736,34566,49396,22906,303,308,13,47
2019년1분기,전통시장,개봉중앙시장,구로구,개봉2동,12272,370,32,5950,6322,8284,3986,170,200,16,16
2019년2분기,전통시장,개봉중앙시장,구로구,개봉2동,13451,370,15,6242,7210,8721,4730,170,200,10,5
2019년1분기,전통시장,오류시장,구로구,오류1동,10626,159,134,5765,4861,7653,2971,85,74,42,92
2019년2분기,전통시장,오류시장,구로구,오류1동,13401,159,77,6949,6451,9577,3822,85,74,23,54
2019년1분기,전통시장,도곡시장,강남구,역삼2동,57463,235,164,23727,33737,40457,17008,109,126,75,89
2019년2분기,전통시장,도곡시장,강남구,역삼2동,67888,235,58,25684,42203,46303,21588,109,126,27,31
2019년1분기,전통시장,강남개포시장,강남구,개포2동,9396,8,237,4678,4718,6817,2579,4,4,112,125
2019년2분기,전통시장,강남개포시장,강남구,개포2동,13636,8,81,6522,7114,9533,4102,4,4,50,31
2019년1분기,전통시장,풍납시장,송파구,풍납1동,134440,2267,62,66418,68020,93335,41111,1126,1141,23,39
2019년2분기,전통시장,풍납시장,송파구,풍납1동,147262,2267,63,74026,73235,101113,46155,1126,1141,27,36
2019년1분기,전통시장,마천시장,송파구,마천2동,62444,958,155,32186,30258,43230,19210,502,456,77,78
2019년2분기,전통시장,마천시장,송파구,마천2동,76493,958,111,38856,37637,52691,23803,502,456,76,35
2019년1분기,전통시장,독산동 우시장,금천구,독산1동,70088,86,929,41276,28813,49479,20609,47,39,673,256
2019년2분기,전통시장,독산동 우시장,금천구,독산1동,83359,86,605,49479,33881,58919,24440,47,39,473,132
2019년1분기,전통시장,남문시장,금천구,독산3동,63788,1682,167,35747,28042,44682,19111,834,848,73,94
2019년2분기,전통시장,남문시장,금천구,독산3동,79465,1682,82,42549,36917,55154,24311,834,848,56,26
2019년1분기,전통시장,대명시장,금천구,시흥1동,21814,10,77,11582,10232,15628,6187,5,5,34,43
2019년2분기,전통시장,대명시장,금천구,시흥1동,26724,10,38,13754,12970,19057,7666,5,5,17,21
2019년1분기,전통시장,방이시장,송파구,방이2동,223852,5244,1555,114867,108982,159143,64714,2503,2741,801,754
2019년2분기,전통시장,방이시장,송파구,방이2동,300969,5244,3029,148565,152400,211029,89939,2503,2741,1247,1782
2019년1분기,전통시장,석촌시장,송파구,석촌동,74399,839,488,39340,35059,51563,22836,421,418,233,255
2019년2분기,전통시장,석촌시장,송파구,석촌동,110492,839,414,55351,55140,75512,34984,421,418,148,266
2019년1분기,전통시장,새마을시장,송파구,잠실본동,278367,2387,575,151813,126553,187563,90810,1162,1225,315,260
2019년2분기,전통시장,새마을시장,송파구,잠실본동,321990,2387,178,173827,148162,209094,112892,1162,1225,105,73
2019년1분기,전통시장,명일골목시장,강동구,명일1동,31930,2011,418,14986,16944,23106,8826,1000,1011,205,213
2019년2분기,전통시장,명일골목시장,강동구,명일1동,116298,2011,87,52162,64136,83081,33217,1000,1011,37,50
2019년1분기,전통시장,현대시장,금천구,시흥1동,439434,2195,239,232319,207114,313251,126185,1058,1137,80,159
2019년2분기,전통시장,현대시장,금천구,시흥1동,532619,2195,121,271848,260773,377373,155247,1058,1137,55,66
2019년1분기,전통시장,박미시장,금천구,시흥3동,3931,287,20,2748,1183,3164,767,150,137,8,12
2019년2분기,전통시장,박미시장,금천구,시흥3동,4492,287,33,2966,1525,3639,852,150,137,24,9
2019년1분기,전통시장,은행나무시장,금천구,시흥5동,28884,403,100,15664,13221,19172,9711,199,204,34,66
2019년2분기,전통시장,은행나무시장,금천구,시흥5동,39541,403,62,20218,19323,26176,13366,199,204,35,27
2019년1분기,전통시장,영등포전통시장,영등포구,영등포동,1669461,2332,4220,771135,898325,1080438,589018,1456,876,1995,2225
2019년2분기,전통시장,영등포전통시장,영등포구,영등포동,1950785,2332,1918,884934,1065851,1255987,694799,1456,876,1031,887
2019년1분기,전통시장,고덕전통시장,강동구,고덕2동,6067,316,161,5042,1026,5121,947,162,154,101,60
2019년2분기,전통시장,고덕전통시장,강동구,고덕2동,9044,316,1029,6981,2063,7435,1611,162,154,945,84
2019년1분기,전통시장,암사종합시장,강동구,암사1동,303088,887,237,153420,149670,218144,84941,460,427,136,101
2019년2분기,전통시장,암사종합시장,강동구,암사1동,339331,887,80,168756,170575,242665,96669,460,427,50,30
2019년1분기,전통시장,양지골목시장,강동구,암사3동,34899,843,96,17920,16979,25266,9633,427,416,42,54
2019년2분기,전통시장,양지골목시장,강동구,암사3동,42085,843,91,21323,20762,30025,12058,427,416,61,30
2019년1분기,전통시장,고분다리골목시장,강동구,천호1동,28493,351,37,14869,13623,19818,8674,183,168,15,22
2019년2분기,전통시장,고분다리골목시장,강동구,천호1동,37064,351,7,19086,17977,25085,11977,183,168,2,5
2019년1분기,발달상권,서울 노원구 노원역_1,노원구,상계6.7동,517483,690,929,205334,312148,361183,156304,309,381,271,658
2019년2분기,발달상권,서울 노원구 노원역_1,노원구,상계6.7동,623373,690,401,235462,387909,429529,193847,309,381,96,305
2019년1분기,발달상권,서울 노원구 노원역_2,노원구,상계6.7동,560733,18,931,246127,314604,422751,137982,15,3,334,597
2019년2분기,발달상권,서울 노원구 노원역_2,노원구,상계6.7동,641853,18,297,273526,368325,477378,164474,15,3,130,167
2019년1분기,발달상권,서울 노원구 노원역_3,노원구,상계2동,1913733,258,1843,896822,1016910,1303687,610044,164,94,739,1104
2019년2분기,발달상권,서울 노원구 노원역_3,노원구,상계2동,2256811,258,485,1013071,1243740,1514870,741941,164,94,181,304
2019년1분기,전통시장,전농로터리시장,동대문구,전농1동,69592,92,105,34750,34841,58701,10892,56,36,49,56
2019년2분기,전통시장,전농로터리시장,동대문구,전농1동,68995,92,17,35118,33877,60144,8850,56,36,10,7
2019년1분기,전통시장,답십리현대시장,동대문구,답십리2동,61039,322,124,34163,26876,44236,16801,164,158,91,33
2019년2분기,전통시장,답십리현대시장,동대문구,답십리2동,71585,322,53,40575,31009,50612,20975,164,158,45,8
2019년1분기,전통시장,답십리시장,동대문구,답십리2동,50698,438,257,22779,27920,34426,16274,204,234,93,164
2019년2분기,전통시장,답십리시장,동대문구,답십리2동,65085,438,99,28939,36145,44087,20994,204,234,41,58
2019년1분기,전통시장,영천시장,서대문구,천연동,81254,360,169,40719,40534,59727,21526,186,174,76,93
2019년2분기,전통시장,영천시장,서대문구,천연동,91273,360,58,44140,47133,65915,25358,186,174,25,33
2019년1분기,전통시장,아현가구거리상점가,서대문구,북아현동,33799,128,117,17401,16398,26626,7173,69,59,66,51
2019년2분기,전통시장,아현가구거리상점가,서대문구,북아현동,40775,128,51,20394,20380,31996,8778,69,59,28,23
2019년1분기,전통시장,인왕시장,서대문구,홍제3동,91804,308,122,42906,48899,68252,23553,153,155,38,84
2019년2분기,전통시장,인왕시장,서대문구,홍제3동,112258,308,51,51637,60622,82726,29532,153,155,7,44
2019년1분기,전통시장,포방터시장,서대문구,홍은1동,117170,510,24,62557,54612,78573,38597,255,255,15,9
2019년2분기,전통시장,포방터시장,서대문구,홍은1동,134058,510,71,70806,63253,88801,45257,255,255,53,18
2019년1분기,발달상권,서울시청,중구,명동,473929,73,18067,272458,201470,431324,42605,45,28,7982,10085
2019년2분기,발달상권,서울시청,중구,명동,584320,73,9762,330197,254125,514486,69835,45,28,5303,4459
2019년1분기,발달상권,시청역_2,중구,소공동,269880,289,16175,156352,113526,235667,34211,131,158,9365,6810
2019년2분기,발달상권,시청역_2,중구,소공동,334865,289,14293,184958,149911,290359,44508,131,158,9492,4801
2019년1분기,발달상권,동대문시장_1,중구,광희동,357422,32,2174,171784,185639,246381,111041,16,16,738,1436
2019년2분기,발달상권,동대문시장_1,중구,광희동,448204,32,1597,208745,239458,304700,143503,16,16,460,1137
2019년1분기,전통시장,통인시장,종로구,청운효자동,92865,688,252,45417,47448,68524,24346,305,383,172,80
2019년2분기,전통시장,통인시장,종로구,청운효자동,120801,688,72,55999,64803,87816,32984,305,383,32,40
2019년1분기,전통시장,광장시장,종로구,종로1.2.3.4가동,144402,61,971,73675,70726,103621,40785,30,31,623,348
2019년2분기,전통시장,광장시장,종로구,종로1.2.3.4가동,144582,61,395,74773,69809,108901,35682,30,31,276,119
2019년1분기,전통시장,동대문종합시장,종로구,종로5.6가동,88042,2,4641,38104,49938,74797,13243,2,0,3247,1394
2019년2분기,전통시장,동대문종합시장,종로구,종로5.6가동,105891,2,1459,44624,61268,89978,15914,2,0,1062,397
2019년1분기,전통시장,종로신진시장,종로구,종로5.6가동,312324,110,592,181105,131219,257117,55204,76,34,334,258
2019년2분기,전통시장,종로신진시장,종로구,종로5.6가동,393265,110,180,222507,170758,322576,70688,76,34,102,78
2019년1분기,전통시장,전곡시장,동대문구,장안2동,8477,237,88,4045,4432,6155,2321,114,123,42,46
2019년2분기,전통시장,전곡시장,동대문구,장안2동,9490,237,71,4507,4982,6736,2754,114,123,38,33
2019년1분기,전통시장,청량리청과물시장,동대문구,제기동,111704,58,107,59524,52180,83712,27992,41,17,62,45
2019년2분기,전통시장,청량리청과물시장,동대문구,제기동,109383,58,11,60736,48646,82138,27244,41,17,7,4
2019년1분기,전통시장,회기시장,동대문구,회기동,182773,1222,141,87360,95412,130053,52720,527,695,57,84
2019년2분기,전통시장,회기시장,동대문구,회기동,205086,1222,63,95944,109141,145359,59729,527,695,18,45
2019년1분기,전통시장,모래내시장,서대문구,남가좌1동,33183,384,18,15899,17283,23730,9453,195,189,14,4
2019년2분기,전통시장,모래내시장,서대문구,남가좌1동,39190,384,14,18328,20862,27663,11527,195,189,9,5
2019년1분기,전통시장,백련시장,서대문구,남가좌2동,51330,155,8,26464,24866,37488,13842,70,85,4,4
2019년2분기,전통시장,백련시장,서대문구,남가좌2동,57622,155,57,29309,28313,41661,15961,70,85,47,10
2019년1분기,전통시장,공덕시장,마포구,아현동,64825,12,1829,36073,28752,51196,13629,7,5,769,1060
2019년2분기,전통시장,공덕시장,마포구,아현동,77769,12,3883,42602,35167,61637,16133,7,5,1806,2077
2019년1분기,발달상권,서대문구 서대문역_1,종로구,교남동,168392,1425,378,88475,79917,136392,31998,695,730,275,103
2019년2분기,발달상권,서대문구 서대문역_1,종로구,교남동,206419,1425,89,109586,96831,168218,38202,695,730,60,29
2019년1분기,발달상권,종각역 젊음의 거리,종로구,종로1.2.3.4가동,1854585,164,3769,1024271,830313,1384881,469703,120,44,1603,2166
2019년2분기,발달상권,종각역 젊음의 거리,종로구,종로1.2.3.4가동,2035839,164,3763,1107461,928376,1515366,520467,120,44,2264,1499
2019년1분기,발달상권,종각역,종로구,종로1.2.3.4가동,53996,3,9951,30809,23187,46520,7476,2,1,7527,2424
2019년2분기,발달상권,종각역,종로구,종로1.2.3.4가동,58697,3,10055,32724,25973,48238,10460,2,1,7801,2254
2019년1분기,발달상권,서울 종로구 광화문역_1,종로구,사직동,329637,12,18896,176950,152686,278042,51594,7,5,10887,8009
2019년2분기,발달상권,서울 종로구 광화문역_1,종로구,사직동,295418,12,14333,158000,137418,247888,47527,7,5,8386,5947
2019년1분기,전통시장,충신시장,종로구,종로5.6가동,76008,171,314,48166,27842,62605,13404,89,82,186,128
2019년2분기,전통시장,충신시장,종로구,종로5.6가동,86791,171,53,54101,32690,70738,16053,89,82,30,23
2019년1분기,전통시장,동문시장,종로구,창신1동,25770,63,33,14591,11179,18619,7151,33,30,27,6
2019년2분기,전통시장,동문시장,종로구,창신1동,29249,63,10,16487,12762,20977,8272,33,30,6,4
2019년1분기,전통시장,창신골목시장,종로구,창신2동,128465,372,127,68408,60056,90695,37769,187,185,62,65
2019년2분기,전통시장,창신골목시장,종로구,창신2동,140804,372,18,74916,65890,98214,42592,187,185,9,9
2019년1분기,전통시장,이경시장,동대문구,휘경1동,8263,235,40,4677,3586,6004,2259,122,113,21,19
2019년2분기,전통시장,이경시장,동대문구,휘경1동,9886,235,14,5353,4533,6977,2909,122,113,7,7
2019년1분기,전통시장,이문제일시장,동대문구,이문2동,9988,73,25,4940,5048,7020,2968,33,40,10,15
2019년2분기,전통시장,이문제일시장,동대문구,이문2동,14904,73,1,6731,8173,10211,4693,33,40,1,0
2019년1분기,전통시장,동부골목시장,중랑구,상봉2동,242988,1529,307,123979,119011,170338,72649,789,740,111,196
2019년2분기,전통시장,동부골목시장,중랑구,상봉2동,287820,1529,184,145929,141890,198464,89359,789,740,69,115
2019년1분기,전통시장,동원시장,중랑구,면목본동,181001,2118,558,90466,90531,128235,52762,1046,1072,251,307
2019년2분기,전통시장,동원시장,중랑구,면목본동,221661,2118,230,109171,112490,155172,66489,1046,1072,100,130
2019년1분기,전통시장,마포시장,마포구,아현동,50036,9,49,27710,22327,39417,10620,3,6,21,28
2019년2분기,전통시장,마포시장,마포구,아현동,59081,9,8,32146,26935,46649,12432,3,6,3,5
2019년1분기,전통시장,아현시장,마포구,아현동,255455,406,356,121459,133997,193895,61559,191,215,101,255
2019년2분기,전통시장,아현시장,마포구,아현동,304854,406,839,141935,162920,229762,75093,191,215,461,378
2019년1분기,전통시장,신수시장,마포구,신수동,31181,68,40,15331,15850,23294,7887,29,39,15,25
2019년2분기,전통시장,신수시장,마포구,신수동,38628,68,28,19180,19448,28534,10095,29,39,16,12
2019년1분기,전통시장,서교시장,마포구,서교동,53729,25,200,23306,30423,33105,20624,18,7,106,94
2019년2분기,전통시장,서교시장,마포구,서교동,58741,25,48,24968,33773,34892,23849,18,7,31,17
2019년1분기,발달상권,서울 종로구 종로3가역_1,종로구,종로1.2.3.4가동,306897,193,3768,189142,117756,232516,74378,155,38,1701,2067
2019년2분기,발달상권,서울 종로구 종로3가역_1,종로구,종로1.2.3.4가동,352906,193,2698,215927,136980,265421,87486,155,38,1215,1483
2019년1분기,발달상권,서울 종로구 종로5가역_1,종로구,종로5.6가동,189532,23,148,101025,88507,135991,53541,5,18,58,90
2019년2분기,발달상권,서울 종로구 종로5가역_1,종로구,종로5.6가동,192147,23,30,102968,89178,142673,49473,5,18,13,17
2019년1분기,발달상권,동대문시장_2,종로구,종로5.6가동,230414,27,544,136273,94141,178458,51955,14,13,316,228
2019년2분기,발달상권,동대문시장_2,종로구,종로5.6가동,283431,27,235,163686,119745,222420,61010,14,13,139,96
2019년1분기,전통시장,동묘시장,종로구,숭인2동,259049,781,414,151319,107729,167934,91114,433,348,247,167
2019년2분기,전통시장,동묘시장,종로구,숭인2동,311286,781,554,180750,130538,199491,111796,433,348,263,291
2019년1분기,전통시장,신설종합시장,종로구,숭인2동,23810,13,156,14803,9007,14305,9506,11,2,116,40
2019년2분기,전통시장,신설종합시장,종로구,숭인2동,29575,13,35,18119,11456,17499,12076,11,2,25,10
2019년1분기,전통시장,남대문시장,중구,회현동,892971,79,11688,392946,500023,716979,175990,49,30,5396,6292
2019년2분기,전통시장,남대문시장,중구,회현동,1095719,79,6883,462810,632908,886330,209390,49,30,2898,3985
2019년1분기,전통시장,신중부시장,중구,광희동,310105,272,1767,202712,107391,260529,49574,190,82,1140,627
2019년2분기,전통시장,신중부시장,중구,광희동,368717,272,3125,235341,133375,311489,57226,190,82,1030,2095
2019년1분기,전통시장,면목골목시장,중랑구,면목7동,143366,1289,129,71777,71590,98818,44546,672,617,57,72
2019년2분기,전통시장,면목골목시장,중랑구,면목7동,161013,1289,56,78489,82525,109360,51652,672,617,22,34
2019년1분기,전통시장,사가정시장,중랑구,면목3.8동,279177,1864,250,156730,122446,194662,84516,929,935,85,165
2019년2분기,전통시장,사가정시장,중랑구,면목3.8동,315198,1864,93,171496,143700,217717,97481,929,935,39,54
2019년1분기,전통시장,중화제일시장,중랑구,묵2동,67689,1890,66,37173,30517,46788,20899,949,941,20,46
2019년2분기,전통시장,중화제일시장,중랑구,묵2동,99378,1890,66,51001,48376,63475,35903,949,941,28,38
2019년1분기,전통시장,영진시장,마포구,서교동,28221,250,38,13409,14812,20439,7782,108,142,23,15
2019년2분기,전통시장,영진시장,마포구,서교동,35676,250,23,16286,19390,25708,9967,108,142,12,11
2019년1분기,전통시장,합정시장,마포구,합정동,28138,87,24,13859,14279,19305,8834,35,52,10,14
2019년2분기,전통시장,합정시장,마포구,합정동,34350,87,24,16572,17778,23383,10966,35,52,10,14
2019년1분기,전통시장,망원시장,마포구,망원1동,106160,1975,255,46892,59268,69919,36241,936,1039,111,144
2019년2분기,전통시장,망원시장,마포구,망원1동,122672,1975,186,53463,69211,80445,42229,936,1039,86,100
2019년1분기,발달상권,서울 종로구 동대문역_1,종로구,창신2동,28713,124,109,15150,13563,20501,8212,64,60,57,52
2019년2분기,발달상권,서울 종로구 동대문역_1,종로구,창신2동,33637,124,31,17671,15966,23898,9738,64,60,18,13
2019년1분기,발달상권,서울 종로구 동대문역_2,종로구,창신1동,362132,584,1685,198708,163425,264979,97159,392,192,650,1035
2019년2분기,발달상권,서울 종로구 동대문역_2,종로구,창신1동,434118,584,751,232484,201635,315562,118557,392,192,232,519
2019년1분기,발달상권,장안동사거리,동대문구,장안2동,492294,4026,2032,261292,230997,345180,147113,1984,2042,939,1093
2019년2분기,발달상권,장안동사거리,동대문구,장안2동,584365,4026,1764,305402,278961,405492,178876,1984,2042,644,1120
2019년1분기,전통시장,인현시장,중구,광희동,38196,143,556,26215,11980,32908,5287,81,62,361,195
2019년2분기,전통시장,인현시장,중구,광희동,44696,143,180,30583,14113,38490,6206,81,62,126,54
2019년1분기,전통시장,평화시장,중구,광희동,53458,5,3741,22550,30907,40661,12795,4,1,2568,1173
2019년2분기,전통시장,평화시장,중구,광희동,68376,5,1433,28574,39801,51822,16553,4,1,1006,427
2019년1분기,전통시장,방산종합시장,중구,을지로동,306804,289,2936,186537,120267,245065,61740,195,94,1886,1050
2019년2분기,전통시장,방산종합시장,중구,을지로동,355117,289,1245,212865,142253,289069,66051,195,94,767,478
2019년1분기,전통시장,태능시장,중랑구,중화2동,158353,967,160,83472,74881,108189,50167,496,471,45,115
2019년2분기,전통시장,태능시장,중랑구,중화2동,184974,967,57,96728,88247,125029,59944,496,471,17,40
2019년1분기,전통시장,묵1동도깨비시장,중랑구,묵1동,75484,1448,38,37193,38290,51860,23624,727,721,20,18
2019년2분기,전통시장,묵1동도깨비시장,중랑구,묵1동,92349,1448,43,43362,48988,63276,29074,727,721,36,7
2019년1분기,전통시장,우림골목시장,중랑구,망우본동,162231,2088,584,80417,81816,116426,45807,1079,1009,217,367
2019년2분기,전통시장,우림골목시장,중랑구,망우본동,189773,2088,345,92205,97569,135464,54305,1079,1009,123,222
2019년1분기,전통시장,월정로시장,양천구,신월1동,30340,1666,49,15784,14554,20540,9798,840,826,30,19
2019년2분기,전통시장,월정로시장,양천구,신월1동,36200,1666,71,17727,18472,24466,11734,840,826,49,22
2019년1분기,전통시장,경창시장,양천구,신월2동,101011,365,170,48513,52498,70604,30410,171,194,54,116
2019년2분기,전통시장,경창시장,양천구,신월2동,46416,365,56,22422,23994,31801,14615,171,194,18,38
2019년1분기,전통시장,신월3동골목시장,양천구,신월3동,17762,342,7,9610,8153,12635,5128,187,155,6,1
2019년2분기,전통시장,신월3동골목시장,양천구,신월3동,20525,342,10,10684,9842,14344,6185,187,155,6,4
2019년1분기,전통시장,신곡종합시장,양천구,신월6동,36880,62,13,21063,15817,27137,9740,30,32,9,4
2019년1분기,발달상권,동묘앞역,종로구,창신1동,76145,873,396,39404,36741,57344,18802,424,449,181,215
2019년2분기,발달상권,동묘앞역,종로구,창신1동,89747,873,869,45384,44363,66945,22802,424,449,772,97
2019년1분기,발달상권,서울 종로구 광화문역_2,종로구,사직동,524774,2467,44020,284405,240371,416042,108731,1088,1379,25468,18552
2019년2분기,발달상권,서울 종로구 광화문역_2,종로구,사직동,586995,2467,25717,313049,273944,453901,133092,1088,1379,16545,9172
2019년1분기,발달상권,서울 동대문구 신설동역_1,동대문구,용신동,267075,306,1755,158672,108403,186582,80492,180,126,789,966
2019년2분기,발달상권,서울 동대문구 신설동역_1,동대문구,용신동,322140,306,749,190362,131778,224270,97871,180,126,320,429
2019년1분기,발달상권,신설동역,종로구,숭인2동,199958,424,561,109251,90707,141968,57987,261,163,269,292
2019년2분기,발달상권,신설동역,종로구,숭인2동,231590,424,202,126181,105407,164709,66879,261,163,110,92
2019년1분기,전통시장,동평화시장,중구,신당동,223443,54,978,105003,118440,186649,36795,24,30,522,456
2019년2분기,전통시장,동평화시장,중구,신당동,306150,54,216,139227,166922,256887,49262,24,30,148,68
2019년1분기,전통시장,청평화시장,중구,신당동,47504,1,987,23320,24185,39874,7630,1,0,363,624
2019년2분기,전통시장,청평화시장,중구,신당동,69721,1,117,32685,37036,59017,10704,1,0,45,72
2019년1분기,전통시장,약수시장,중구,약수동,249236,927,623,124457,124780,186206,63030,432,495,275,348
2019년2분기,전통시장,약수시장,중구,약수동,292931,927,288,145074,147855,217790,75140,432,495,129,159
2019년1분기,전통시장,유영시장,중랑구,망우3동,5926,116,70,2957,2969,4526,1401,60,56,20,50
2019년2분기,전통시장,유영시장,중랑구,망우3동,7938,116,32,3835,4104,5885,2054,60,56,7,25
2019년1분기,전통시장,돈암제일시장,성북구,삼선동,252491,218,232,115400,137090,189241,63247,96,122,96,136
2019년2분기,전통시장,돈암제일시장,성북구,삼선동,301817,218,102,137804,164013,226848,74969,96,122,27,75
2019년1분기,전통시장,정릉아리랑시장,성북구,정릉2동,12655,1058,80,6762,5894,8194,4460,517,541,32,48
2019년2분기,전통시장,정릉아리랑시장,성북구,정릉2동,27208,1058,35,13654,13555,17676,9535,517,541,10,25
2019년1분기,전통시장,정릉시장,성북구,정릉3동,156707,1419,313,86954,69753,109492,47214,730,689,156,157
2019년2분기,전통시장,정릉시장,성북구,정릉3동,211784,1419,115,114994,96786,146723,65059,730,689,58,57
2019년1분기,전통시장,망원월드컵시장,마포구,망원2동,105873,807,267,49082,56791,73694,32176,365,442,156,111
2019년2분기,전통시장,망원월드컵시장,마포구,망원2동,136194,807,232,62630,73563,94917,41277,365,442,141,91
2019년1분기,전통시장,동진시장,마포구,연남동,51265,36,50,21902,29363,33342,17922,20,16,23,27
2019년2분기,전통시장,동진시장,마포구,연남동,57725,36,10,24835,32890,37427,20297,20,16,5,5
2019년1분기,전통시장,목2동시장,양천구,목2동,142961,1213,263,78025,64938,106633,36328,615,598,94,169
2019년2분기,전통시장,목2동시장,양천구,목2동,175935,1213,426,93167,82768,130789,45147,615,598,233,193
2019년1분기,발달상권,서울 종로구 종로5가역_2,종로구,종로5.6가동,713798,2044,15994,416409,297387,585323,128472,1021,1023,9901,6093
2019년2분기,발달상권,서울 종로구 종로5가역_2,종로구,종로5.6가동,794391,2044,11914,454691,339700,648106,146290,1021,1023,7932,3982
2019년1분기,발달상권,종로구청,종로구,종로1.2.3.4가동,376903,550,55674,209022,167882,312767,64139,310,240,34488,21186
2019년2분기,발달상권,종로구청,종로구,종로1.2.3.4가동,430709,550,22114,235430,195281,353675,77037,310,240,12078,10036
2019년1분기,발달상권,서울 종로구 종로5가역_3,종로구,종로5.6가동,571680,715,3106,318029,253650,478082,93600,432,283,1868,1238
2019년2분기,발달상권,서울 종로구 종로5가역_3,종로구,종로5.6가동,719515,715,1775,387033,332480,601953,117566,432,283,1159,616
2019년1분기,전통시장,백학시장,중구,신당5동,116564,829,201,63211,53354,86893,29672,444,385,112,89
2019년2분기,전통시장,백학시장,중구,신당5동,136323,829,102,72828,63492,99974,36346,444,385,52,50
2019년1분기,전통시장,서울중앙시장,중구,황학동,262564,1014,858,138595,123968,199576,62995,543,471,542,316
2019년2분기,전통시장,서울중앙시장,중구,황학동,309889,1014,497,159783,150106,234346,75545,543,471,345,152
2019년1분기,전통시장,합동(새벽)시장,중구,중림동,24865,93,1138,13899,10966,19009,5857,74,19,653,485
2019년2분기,전통시장,합동(새벽)시장,중구,중림동,25728,93,715,14240,11489,19180,6547,74,19,487,228
2019년1분기,전통시장,길음시장,성북구,길음1동,91521,17,94,45889,45633,65824,25699,13,4,51,43
2019년2분기,전통시장,길음시장,성북구,길음1동,103492,17,18,50730,52762,73981,29511,13,4,5,13
2019년1분기,전통시장,밤나무골시장,성북구,월곡1동,36376,236,25,18074,18303,26275,10104,114,122,5,20
2019년2분기,전통시장,밤나무골시장,성북구,월곡1동,42421,236,13,20729,21691,30102,12319,114,122,1,12
2019년1분기,전통시장,장위전통시장,성북구,장위2동,105856,1115,127,52241,53616,76944,28914,542,573,68,59
2019년2분기,전통시장,장위전통시장,성북구,장위2동,122766,1115,74,60505,62261,87022,35746,542,573,43,31
2019년1분기,전통시장,번동시장,성북구,장위3동,40,30,15,37,3,30,10,16,14,11,4
2019년2분기,전통시장,번동시장,성북구,장위3동,483,30,15,387,97,376,108,16,14,11,4
2019년1분기,전통시장,목3동시장,양천구,목3동,193057,1169,615,95239,97818,141162,51895,585,584,306,309
2019년2분기,전통시장,목3동시장,양천구,목3동,224637,1169,181,108319,116318,163092,61544,585,584,82,99
2019년1분기,전통시장,목4동시장,양천구,목4동,31883,1159,80,16518,15367,23808,8074,583,576,21,59
2019년2분기,전통시장,목4동시장,양천구,목4동,41382,1159,84,20794,20590,29595,11785,583,576,48,36
2019년1분기,전통시장,신영시장,양천구,신월1동,49997,1199,173,26418,23578,34388,15610,589,610,72,101
2019년2분기,전통시장,신영시장,양천구,신월1동,65050,1199,54,32497,32552,44806,20249,589,610,25,29
2019년1분기,발달상권,서울 종로구 종로5가역_4,종로구,종로1.2.3.4가동,62948,290,1421,35921,27026,51431,11517,171,119,841,580
2019년2분기,발달상권,서울 종로구 종로5가역_4,종로구,종로1.2.3.4가동,71750,290,1304,41447,30304,57556,14193,171,119,937,367
2019년1분기,발달상권,인사동,종로구,종로1.2.3.4가동,579379,769,19641,314022,265358,440254,139119,410,359,12064,7577
2019년2분기,발달상권,인사동,종로구,종로1.2.3.4가동,575182,769,25772,310581,264603,428701,146487,410,359,15160,10612
2019년1분기,발달상권,서울 동대문구 신설동역_2,동대문구,용신동,396175,418,1246,225865,170310,301133,95037,256,162,575,671
2019년2분기,발달상권,서울 동대문구 신설동역_2,동대문구,용신동,489848,418,4387,285460,204387,379479,110367,256,162,1150,3237
2019년1분기,전통시장,후암시장,용산구,후암동,23124,285,28,12832,10291,17078,6048,148,137,11,17
2019년2분기,전통시장,후암시장,용산구,후암동,27249,285,22,14871,12379,19809,7440,148,137,20,2
2019년1분기,전통시장,신흥시장,용산구,용산2가동,16037,97,35,7916,8121,11138,4899,54,43,21,14
2019년2분기,전통시장,신흥시장,용산구,용산2가동,19709,97,7,9779,9929,13385,6323,54,43,4,3
2019년1분기,전통시장,만리시장,용산구,청파동,16218,32,37,8184,8035,12019,4200,19,13,28,9
2019년2분기,전통시장,만리시장,용산구,청파동,16503,32,15,8255,8248,12143,4360,19,13,12,3
2019년1분기,전통시장,용문전통시장,용산구,용문동,145777,466,97,84615,61163,108172,37603,239,227,49,48
2019년2분기,전통시장,용문전통시장,용산구,용문동,147349,466,25,81770,65579,107517,39830,239,227,9,16
2019년1분기,전통시장,새석관시장,성북구,석관동,10299,80,23,5183,5116,7438,2859,42,38,17,6
2019년2분기,전통시장,새석관시장,성북구,석관동,11834,80,4,6179,5655,8335,3498,42,38,1,3
2019년1분기,전통시장,석관시장,성북구,석관동,9674,158,27,4629,5045,6803,2872,88,70,15,12
2019년2분기,전통시장,석관시장,성북구,석관동,10875,158,30,4969,5905,7642,3232,88,70,19,11
2019년1분기,전통시장,석관황금시장,성북구,석관동,122187,1847,39,63067,59118,86558,35635,959,888,23,16
2019년2분기,전통시장,석관황금시장,성북구,석관동,143462,1847,177,71789,71672,99401,44060,959,888,147,30
2019년1분기,발달상권,서울 광진구 군자역,광진구,군자동,268671,1740,1982,144817,123855,195750,72921,794,946,1215,767
2019년2분기,발달상권,서울 광진구 군자역,광진구,군자동,433446,1740,726,224506,208943,314432,119014,794,946,433,293
2019년1분기,발달상권,홍익대학교 주변,마포구,서교동,6308594,4775,17048,2956917,3351674,4087618,2220967,2278,2497,8543,8505
2019년2분기,발달상권,홍익대학교 주변,마포구,서교동,7379300,4775,10364,3406815,3972486,4705209,2674096,2278,2497,5912,4452
2019년1분기,발달상권,서울 마포구 홍대입구역_2,마포구,서교동,264750,504,2503,134802,129951,196471,68279,246,258,925,1578
2019년2분기,발달상권,서울 마포구 홍대입구역_2,마포구,서교동,314525,504,1685,153818,160707,232898,81628,246,258,599,1086
2019년1분기,발달상권,서울 종로구 종로3가역_2,종로구,종로1.2.3.4가동,1392017,2251,2652,797597,594416,996321,395690,1543,708,1308,1344
2019년2분기,발달상권,서울 종로구 종로3가역_2,종로구,종로1.2.3.4가동,1547945,2251,909,887761,660185,1099734,448209,1543,708,446,463
2019년1분기,발달상권,서울 종로구 종로3가역_3,종로구,종로1.2.3.4가동,211093,147,3047,119497,91595,160454,50638,118,29,1575,1472
2019년2분기,발달상권,서울 종로구 종로3가역_3,종로구,종로1.2.3.4가동,257660,147,1208,145240,112420,196452,61206,118,29,595,613
2019년1분기,발달상권,서울 종로구 경복궁역_1,종로구,사직동,389304,582,507,204118,185188,288421,100885,283,299,255,252
2019년2분기,발달상권,서울 종로구 경복궁역_1,종로구,사직동,496887,582,633,248560,248324,358113,138774,283,299,422,211
2019년1분기,전통시장,이촌종합시장,용산구,이촌1동,22444,99,162,10371,12073,15552,6892,56,43,92,70
2019년2분기,전통시장,이촌종합시장,용산구,이촌1동,20314,99,100,9200,11114,13783,6532,56,43,71,29
2019년1분기,전통시장,이태원시장,용산구,이태원1동,20712,63,220,9979,10732,11753,8958,30,33,127,93
2019년2분기,전통시장,이태원시장,용산구,이태원1동,26226,63,50,12572,13654,14230,11997,30,33,30,20
2019년1분기,전통시장,이태원제일시장,용산구,이태원2동,22305,45,28,10871,11434,15104,7201,20,25,13,15
2019년2분기,전통시장,이태원제일시장,용산구,이태원2동,30105,45,3,14452,15653,19987,10118,20,25,2,1
2019년1분기,전통시장,보광시장,용산구,보광동,11531,4,48,6288,5243,8376,3154,1,3,21,27
2019년2분기,전통시장,보광시장,용산구,보광동,14182,4,14,7498,6684,10145,4035,1,3,6,8
2019년1분기,전통시장,동북시장,강북구,삼양동,64840,30,132,33308,31532,45544,19295,15,15,61,71
2019년2분기,전통시장,동북시장,강북구,삼양동,70463,30,104,35175,35288,48666,21797,15,15,39,65
2019년1분기,전통시장,방천골목시장,강북구,송중동,271534,1530,199,137879,133652,189189,82343,760,770,110,89
2019년2분기,전통시장,방천골목시장,강북구,송중동,337223,1530,98,162930,174293,232991,104237,760,770,61,37
2019년1분기,전통시장,숭인시장,강북구,송천동,69334,232,246,33937,35397,48554,20779,124,108,100,146
2019년2분기,전통시장,숭인시장,강북구,송천동,87571,232,57,41816,45755,60868,26703,124,108,25,32
2019년1분기,전통시장,솔샘시장,강북구,삼각산동,118262,138,171,60185,58077,82974,35288,68,70,59,112
2019년2분기,전통시장,솔샘시장,강북구,삼각산동,133758,138,86,66130,67628,92372,41384,68,70,36,50
2019년1분기,발달상권,서울 마포구 홍대입구역_3,마포구,서교동,773409,191,2794,340641,432767,549087,224323,88,103,1105,1689
2019년2분기,발달상권,서울 마포구 홍대입구역_3,마포구,서교동,899110,191,877,386940,512172,635966,263145,88,103,348,529
2019년1분기,발달상권,서울 서대문구 신촌역,서대문구,신촌동,5298385,2715,4002,2472201,2826187,3633137,1665249,1395,1320,1723,2279
2019년2분기,발달상권,서울 서대문구 신촌역,서대문구,신촌동,6171393,2715,969,2801737,3369657,4150588,2020808,1395,1320,401,568
2019년1분기,발달상권,서울 서대문구 이대역,서대문구,신촌동,1179386,1753,1207,379615,799772,869337,310052,548,1205,555,652
2019년2분기,발달상권,서울 서대문구 이대역,서대문구,신촌동,1418987,1753,377,429486,989500,1059711,359280,548,1205,158,219
2019년1분기,발달상권,서울 종로구 안국역_1,종로구,가회동,89532,116,19553,52439,37094,74581,14951,47,69,17300,2253
2019년2분기,발달상권,서울 종로구 안국역_1,종로구,가회동,115051,116,3070,63272,51779,93168,21883,47,69,2122,948
2019년1분기,발달상권,서울 종로구 안국역_2,종로구,삼청동,183264,280,976,100672,82591,148001,35264,130,150,443,533
2019년2분기,발달상권,서울 종로구 안국역_2,종로구,삼청동,239236,280,1657,123728,115509,188562,50674,130,150,826,831
2019년1분기,발달상권,서울 종로구 경복궁역_2,종로구,사직동,132538,308,593,71016,61523,100510,32028,140,168,259,334
2019년2분기,발달상권,서울 종로구 경복궁역_2,종로구,사직동,172825,308,305,88219,84606,126362,46462,140,168,143,162
2019년1분기,발달상권,서울 동대문구 청량리역,동대문구,전농1동,1065191,2803,1781,557337,507849,737736,327456,1414,1389,786,995
2019년2분기,발달상권,서울 동대문구 청량리역,동대문구,전농1동,1229267,2803,925,639913,589351,836224,393045,1414,1389,471,454
2019년1분기,전통시장,마장축산물시장,성동구,마장동,91863,335,1715,53507,38354,70789,21074,184,151,1162,553
2019년2분기,전통시장,마장축산물시장,성동구,마장동,117963,335,615,67212,50751,90733,27232,184,151,416,199
2019년1분기,전통시장,행당시장,성동구,행당1동,317173,1537,637,145957,171214,226917,90256,764,773,278,359
2019년2분기,전통시장,행당시장,성동구,행당1동,369417,1537,342,167056,202360,260725,108692,764,773,155,187
2019년1분기,전통시장,금남시장,성동구,금호2.3가동,36349,255,111,18788,17560,25952,10395,130,125,27,84
2019년2분기,전통시장,금남시장,성동구,금호2.3가동,39452,255,31,19627,19826,27887,11566,130,125,12,19
2019년1분기,전통시장,뚝도시장,성동구,성수2가1동,42772,572,145,23690,19083,31602,11171,315,257,77,68
2019년2분기,전통시장,뚝도시장,성동구,성수2가1동,50432,572,62,27291,23141,37020,13415,315,257,36,26
2019년1분기,전통시장,번동북부골목시장,강북구,번1동,109651,1164,85,54874,54775,76365,33281,575,589,40,45
2019년2분기,전통시장,번동북부골목시장,강북구,번1동,128002,1164,51,62942,65060,87631,40368,575,589,27,24
2019년1분기,전통시장,수유전통시장,강북구,수유1동,126280,628,298,59653,66627,90253,36027,306,322,145,153
2019년2분기,전통시장,수유전통시장,강북구,수유1동,144093,628,133,65179,78914,104449,39643,306,322,68,65
2019년1분기,전통시장,우이시장,강북구,수유2동,91367,1669,133,43793,47575,63737,27632,821,848,48,85
2019년2분기,전통시장,우이시장,강북구,수유2동,103285,1669,70,48849,54435,70121,33161,821,848,53,17
2019년1분기,발달상권,한양시장,성동구,사근동,322796,1037,330,178392,144405,234478,88321,484,553,171,159
2019년2분기,발달상권,한양시장,성동구,사근동,381230,1037,44,207746,173485,277910,103323,484,553,22,22
2019년1분기,발달상권,장충동 족발거리,중구,장충동,91750,298,1592,49014,42736,70523,21224,154,144,1124,468
2019년2분기,발달상권,장충동 족발거리,중구,장충동,135531,298,2514,70705,64826,105605,29923,154,144,1233,1281
2019년1분기,발달상권,서울 중구 명동역,중구,명동,231561,1257,8002,107505,124056,175417,56146,601,656,4224,3778
2019년2분기,발달상권,서울 중구 명동역,중구,명동,294461,1257,10846,131216,163244,223090,71373,601,656,7088,3758
2019년1분기,발달상권,장한평역,성동구,용답동,77496,1232,6926,51320,26177,62098,15399,884,348,4422,2504
2019년2분기,발달상권,장한평역,성동구,용답동,99552,1232,3895,64806,34747,80123,19432,884,348,2272,1623
2019년1분기,발달상권,디지털미디어시티,마포구,상암동,292807,1576,18781,159429,133377,248774,44034,707,869,11285,7496
2019년2분기,발달상권,디지털미디어시티,마포구,상암동,384689,1576,6841,204036,180653,318083,66607,707,869,4400,2441
2019년1분기,발달상권,혜화역 대학로_1,종로구,이화동,819725,486,1786,345719,474008,535390,284337,236,250,795,991
2019년2분기,발달상권,혜화역 대학로_1,종로구,이화동,973012,486,1581,392575,580437,630379,342633,236,250,798,783
2019년1분기,발달상권,혜화역 대학로_2,종로구,혜화동,352752,804,336,172393,180359,238441,114309,396,408,144,192
2019년2분기,발달상권,혜화역 대학로_2,종로구,혜화동,418139,804,337,200076,218063,284120,134023,396,408,266,71
2019년1분기,전통시장,성동용답상가시장,성동구,용답동,88376,1990,149,48792,39584,61150,27230,1009,981,69,80
2019년2분기,전통시장,성동용답상가시장,성동구,용답동,100762,1990,55,54337,46425,69202,31561,1009,981,31,24
2019년1분기,전통시장,한아름시장,광진구,화양동,75479,12,109,38628,36851,50195,25283,10,2,60,49
2019년2분기,전통시장,한아름시장,광진구,화양동,85798,12,68,42434,43364,56356,29442,10,2,43,25
2019년1분기,전통시장,화양제일골목시장,광진구,화양동,128824,928,63,66175,62649,85835,42988,401,527,31,32
2019년2분기,전통시장,화양제일골목시장,광진구,화양동,146751,928,30,72567,74185,96467,50283,401,527,7,23
2019년1분기,전통시장,강북종합시장,강북구,수유3동,105699,734,104,54534,51165,73977,31725,381,353,50,54
2019년2분기,전통시장,강북종합시장,강북구,수유3동,124866,734,45,62585,62282,86768,38102,381,353,24,21
2019년1분기,전통시장,수유중앙시장,강북구,수유3동,3932,49,41,1983,1949,2571,1361,29,20,23,18
2019년2분기,전통시장,수유중앙시장,강북구,수유3동,5020,49,9,2428,2592,3328,1691,29,20,5,4
2019년1분기,전통시장,장미원골목시장,강북구,우이동,92725,1479,93,43721,49003,64117,28611,719,760,37,56
2019년2분기,전통시장,장미원골목시장,강북구,우이동,109453,1479,958,52730,56721,74089,35365,719,760,615,343
2019년1분기,발달상권,서울 중구 충무로역_1,중구,필동,359047,773,4871,207073,151975,292582,66464,383,390,3075,1796
2019년2분기,발달상권,서울 중구 충무로역_1,중구,필동,459600,773,4375,261021,198578,372295,87307,383,390,2786,1589
2019년1분기,발달상권,장한평역_1,동대문구,장안1동,138613,206,2614,85090,53525,101074,37538,142,64,1567,1047
2019년2분기,발달상권,장한평역_1,동대문구,장안1동,159485,206,1134,98764,60720,119348,40138,142,64,766,368
2019년1분기,발달상권,혜화역 대학로_3,종로구,혜화동,1120550,628,1193,520559,599991,759237,361318,298,330,548,645
2019년2분기,발달상권,혜화역 대학로_3,종로구,혜화동,1319784,628,516,599298,720488,899117,420666,298,330,229,287
2019년1분기,발달상권,서울 성북구 안암역,성북구,안암동,374637,371,361,219978,154660,292575,82064,183,188,215,146
2019년2분기,발달상권,서울 성북구 안암역,성북구,안암동,492709,371,76,287094,205614,385235,107473,183,188,39,37
2019년1분기,발달상권,경희대학교,동대문구,회기동,821872,370,329,399004,422865,621924,199945,160,210,161,168
2019년2분기,발달상권,경희대학교,동대문구,회기동,1000680,370,82,475940,524744,756673,244006,160,210,32,50
2019년1분기,전통시장,중곡제일시장,광진구,중곡1동,134444,802,622,61366,73077,93505,40942,411,391,132,490
2019년2분기,전통시장,중곡제일시장,광진구,중곡1동,164948,802,122,73949,91000,113870,51075,411,391,70,52
2019년1분기,전통시장,면곡골목시장,광진구,중곡3동,53780,452,135,31238,22543,36991,16789,237,215,45,90
2019년2분기,전통시장,면곡골목시장,광진구,중곡3동,63411,452,62,35616,27793,42641,20768,237,215,44,18
2019년1분기,전통시장,신성골목시장,광진구,중곡4동,19080,99,118,8989,10091,13912,5167,47,52,55,63
2019년2분기,전통시장,신성골목시장,광진구,중곡4동,23492,99,10,10985,12507,17027,6465,47,52,3,7
2019년1분기,전통시장,자양골목시장,광진구,자양1동,174507,2013,75,84655,89854,121282,53223,972,1041,43,32
2019년2분기,전통시장,자양골목시장,광진구,자양1동,186315,2013,63,89210,97106,127716,58602,972,1041,34,29
2019년1분기,전통시장,수유북부시장,강북구,인수동,5971,63,24,2834,3137,4227,1745,33,30,16,8
2019년2분기,전통시장,수유북부시장,강북구,인수동,7697,63,19,3775,3921,5202,2493,33,30,13,6
2019년1분기,전통시장,창동신창시장,도봉구,창2동,109295,2295,246,57209,52085,76595,32702,1126,1169,115,131
2019년2분기,전통시장,창동신창시장,도봉구,창2동,128452,2295,82,66129,62326,88540,39913,1126,1169,33,49
2019년1분기,전통시장,창동골목시장,도봉구,창3동,3034,1245,105,1774,1260,2213,823,605,640,36,69
2019년2분기,전통시장,창동골목시장,도봉구,창3동,4548,1245,106,2739,1809,3224,1322,605,640,52,54
2019년1분기,전통시장,신도봉시장,도봉구,도봉1동,5864,174,48,2934,2930,4177,1688,89,85,23,25
2019년2분기,전통시장,신도봉시장,도봉구,도봉1동,7526,174,9,3815,3711,5063,2463,89,85,6,3
2019년1분기,발달상권,서울 강서구 발산역,강서구,등촌3동,470859,107,2123,206287,264571,321577,149281,57,50,1180,943
2019년2분기,발달상권,서울 강서구 발산역,강서구,등촌3동,552064,107,1381,233280,318786,375690,176374,57,50,854,527
2019년1분기,발달상권,왕십리역_2,성동구,왕십리도선동,102389,531,1715,53052,49335,75024,27362,252,279,538,1177
2019년2분기,발달상권,왕십리역_2,성동구,왕십리도선동,123646,531,295,62124,61522,89892,33757,252,279,151,144
2019년1분기,발달상권,시청역_1,중구,소공동,304587,360,49346,184497,120087,281132,23457,188,172,32844,16502
2019년2분기,발달상권,시청역_1,중구,소공동,402973,360,38617,237609,165363,369303,33669,188,172,23204,15413
2019년1분기,발달상권,서울 성북구 성신여대입구역,성북구,동선동,1618261,1091,3952,727944,890315,1120475,497793,500,591,2161,1791
2019년2분기,발달상권,서울 성북구 성신여대입구역,성북구,동선동,1868067,1091,1309,813551,1054516,1292512,575550,500,591,888,421
2019년1분기,발달상권,미아사거리_1,성북구,월곡1동,67360,914,387,30857,36504,45807,21554,438,476,139,248
2019년2분기,발달상권,미아사거리_1,성북구,월곡1동,93808,914,200,41632,52176,63093,30716,438,476,96,104
2019년1분기,발달상권,미아사거리_2,성북구,길음2동,57926,90,258,22502,35425,36464,21464,44,46,98,160
2019년2분기,발달상권,미아사거리_2,성북구,길음2동,82445,90,97,31169,51276,51393,31051,44,46,50,47
2019년1분기,전통시장,자양종합시장,광진구,자양2동,12265,59,14,6195,6071,8625,3639,31,28,10,4
2019년2분기,전통시장,자양종합시장,광진구,자양2동,15393,59,16,7548,7845,10643,4751,31,28,10,6
2019년1분기,전통시장,노룬산골목시장,광진구,자양4동,36316,194,85,18827,17489,26158,10160,95,99,43,42
2019년2분기,전통시장,노룬산골목시장,광진구,자양4동,35108,194,26,17268,17841,24676,10434,95,99,14,12
2019년1분기,전통시장,능동로골목시장,광진구,자양3동,70982,368,37,36627,34354,50074,20909,197,171,19,18
2019년2분기,전통시장,능동로골목시장,광진구,자양3동,80776,368,10,39938,40838,55983,24791,197,171,9,1
2019년1분기,전통시장,백운시장,도봉구,쌍문1동,16891,374,44,7306,9585,11622,5270,176,198,21,23
2019년2분기,전통시장,백운시장,도봉구,쌍문1동,25619,374,30,10613,15007,17714,7905,176,198,13,17
2019년1분기,전통시장,쌍문역골목시장,도봉구,쌍문3동,47468,763,32,23894,23574,34645,12821,366,397,16,16
2019년2분기,전통시장,쌍문역골목시장,도봉구,쌍문3동,69587,763,58,33904,35684,47041,22550,366,397,14,44
2019년1분기,전통시장,방학동도깨비시장,도봉구,방학2동,156698,1000,168,84135,72561,107692,49005,502,498,72,96
2019년2분기,전통시장,방학동도깨비시장,도봉구,방학2동,197619,1000,46,101700,95917,134911,62708,502,498,16,30
2019년1분기,전통시장,공릉동도깨비시장,노원구,공릉1동,86520,1582,448,44389,42133,61231,25290,788,794,247,201
2019년2분기,전통시장,공릉동도깨비시장,노원구,공릉1동,103971,1582,209,52191,51781,73583,30388,788,794,165,44
2019년1분기,발달상권,장한평역_2,동대문구,장안1동,307146,1406,2933,185705,121442,237212,69934,735,671,1826,1107
2019년2분기,발달상권,장한평역_2,동대문구,장안1동,319425,1406,1648,191106,128319,244992,74436,735,671,1063,585
2019년1분기,발달상권,서울 강서구 송정역,강서구,공항동,113447,2167,633,63262,50184,82194,31250,1074,1093,301,332
2019년2분기,발달상권,서울 강서구 송정역,강서구,공항동,141728,2167,407,80196,61533,102122,39601,1074,1093,199,208
2019년1분기,발달상권,서울 중구 충무로역_2,중구,필동,902159,1434,25323,558974,343186,768199,133962,757,677,12995,12328
2019년2분기,발달상권,서울 중구 충무로역_2,중구,필동,1051150,1434,17551,640842,410309,896314,154834,757,677,7586,9965
2019년1분기,발달상권,서울 은평구 불광역_1,은평구,대조동,519012,537,634,255559,263453,363703,155308,268,269,287,347
2019년2분기,발달상권,서울 은평구 불광역_1,은평구,대조동,562818,537,222,279528,283291,390354,172465,268,269,105,117
2019년1분기,발달상권,서울 은평구 불광역_2,은평구,불광1동,430209,668,441,213449,216763,312223,117991,328,340,134,307
2019년2분기,발달상권,서울 은평구 불광역_2,은평구,불광1동,486552,668,118,238778,247774,347496,139057,328,340,40,78
2019년1분기,발달상권,서울 은평구 불광역_3,은평구,대조동,325225,775,259,160790,164434,234915,90309,334,441,88,171
2019년2분기,발달상권,서울 은평구 불광역_3,은평구,대조동,354780,775,87,171217,183563,251254,103528,334,441,31,56
2019년1분기,전통시장,영동교골목시장,광진구,자양4동,98204,954,27,52641,45563,68486,29718,476,478,10,17
2019년2분기,전통시장,영동교골목시장,광진구,자양4동,99359,954,19,53334,46027,67723,31638,476,478,12,7
2019년1분기,전통시장,조양시장,광진구,자양4동,19842,78,152,9132,10710,13606,6235,36,42,91,61
2019년2분기,전통시장,조양시장,광진구,자양4동,11636,78,33,5362,6274,7911,3725,36,42,18,15
2019년1분기,전통시장,구의시장,광진구,구의2동,33695,158,8,16799,16896,24486,9209,78,80,4,4
2019년2분기,전통시장,구의시장,광진구,구의2동,42871,158,8,21218,21654,30477,12394,78,80,4,4
2019년1분기,전통시장,상계중앙시장,노원구,상계5동,281406,1972,299,140016,141390,204150,77255,961,1011,122,177
2019년2분기,전통시장,상계중앙시장,노원구,상계5동,321443,1972,132,151911,169531,232188,89259,961,1011,67,65
2019년1분기,전통시장,연서시장,은평구,불광2동,87087,256,287,42740,44348,61732,25355,125,131,137,150
2019년2분기,전통시장,연서시장,은평구,불광2동,106257,256,200,50835,55422,74771,31487,125,131,139,61
2019년1분기,발달상권,북창동,중구,소공동,442114,250,8135,244931,197184,375661,66458,158,92,4122,4013
2019년2분기,발달상권,북창동,중구,소공동,563797,250,6996,296429,267368,470394,93404,158,92,3577,3419
2019년1분기,발달상권,서울 중구 신당역_1,중구,신당5동,465887,870,1100,250893,214993,355776,110112,482,388,538,562
2019년2분기,발달상권,서울 중구 신당역_1,중구,신당5동,561923,870,397,295477,266446,426141,135784,482,388,195,202
2019년1분기,발달상권,서울 강북구 미아삼거리역_1,강북구,송중동,638290,368,1081,309385,328905,443835,194457,201,167,458,623
2019년2분기,발달상권,서울 강북구 미아삼거리역_1,강북구,송중동,832578,368,307,390145,442433,574304,258272,201,167,207,100
2019년1분기,발달상권,서울 강북구 미아삼거리역_2,성북구,길음2동,183089,452,495,86873,96214,130526,52561,248,204,190,305
2019년2분기,발달상권,서울 강북구 미아삼거리역_2,성북구,길음2동,194581,452,292,89160,105422,137705,56875,248,204,137,155
2019년1분기,발달상권,서울 은평구 연신내역_1,은평구,대조동,1441130,221,218,715742,725387,1017490,423639,95,126,73,145
2019년2분기,발달상권,서울 은평구 연신내역_1,은평구,대조동,1701593,221,58,820746,880848,1188680,512913,95,126,23,35
2019년1분기,전통시장,용두시장,동대문구,용신동,21168,22,6,12005,9163,16371,4797,15,7,4,2
2019년2분기,전통시장,용두시장,동대문구,용신동,22376,22,4,11948,10428,17185,5191,15,7,2,2
2019년1분기,전통시장,청량리수산시장,동대문구,용신동,6835,479,175,2657,4177,6379,457,257,222,83,92
2019년2분기,전통시장,청량리수산시장,동대문구,용신동,9692,479,20,3371,6320,8897,795,257,222,12,8
2019년1분기,전통시장,경동시장,동대문구,제기동,46897,8,274,24148,22750,35572,11324,4,4,182,92
2019년2분기,전통시장,경동시장,동대문구,제기동,54676,8,148,27796,26881,41874,12803,4,4,67,81
2019년1분기,전통시장,동서시장,동대문구,제기동,651,3,26,3,649,651,0,3,0,18,8
2019년2분기,전통시장,동서시장,동대문구,제기동,7681,3,4,3900,3781,6259,1422,3,0,3,1
2019년1분기,전통시장,갈현시장,은평구,갈현1동,13336,177,57,7103,6233,9187,4149,87,90,28,29
2019년2분기,전통시장,갈현시장,은평구,갈현1동,15936,177,1,8164,7772,10700,5236,87,90,1,0
2019년1분기,전통시장,역촌중앙시장,은평구,갈현2동,16994,11,30,7970,9024,12063,4932,8,3,12,18
2019년2분기,전통시장,역촌중앙시장,은평구,갈현2동,19490,11,2,8770,10720,13564,5925,8,3,2,0
2019년1분기,전통시장,대조시장,은평구,대조동,17163,482,74,8363,8800,11779,5384,239,243,21,53
2019년2분기,전통시장,대조시장,은평구,대조동,19846,482,11,9755,10091,13528,6318,239,243,4,7
2019년1분기,전통시장,녹번시장,은평구,응암1동,3833,15,100,1962,1872,3140,694,10,5,38,62
2019년2분기,전통시장,녹번시장,은평구,응암1동,4730,15,30,2501,2228,3739,991,10,5,14,16
2019년1분기,발달상권,명동거리,중구,명동,1336752,139,17311,590703,746049,999102,337650,81,58,5640,11671
2019년2분기,발달상권,명동거리,중구,명동,1663702,139,33325,712817,950882,1248423,415277,81,58,13963,19362
2019년1분기,발달상권,서울 중구 을지로3가역_1,중구,을지로동,768626,325,17794,464758,303864,640083,128535,191,134,10301,7493
2019년2분기,발달상권,서울 중구 을지로3가역_1,중구,을지로동,1004956,325,4668,587049,417909,829113,175844,191,134,2292,2376
2019년1분기,발달상권,동대문역사문화공원역,중구,광희동,419594,433,1958,218660,200933,316882,102713,265,168,1103,855
2019년2분기,발달상권,동대문역사문화공원역,중구,광희동,500433,433,3244,254099,246332,376320,124115,265,168,2583,661
2019년1분기,발달상권,서울 은평구 연신내역_2,은평구,갈현1동,2420962,1059,1164,1201313,1219648,1697358,723607,520,539,430,734
2019년2분기,발달상권,서울 은평구 연신내역_2,은평구,갈현1동,2878198,1059,598,1387192,1491008,1998371,879828,520,539,172,426
2019년1분기,발달상권,서울 은평구 연신내역_3,은평구,불광2동,26229,112,156,10865,15364,19732,6496,59,53,40,116
2019년2분기,발달상권,서울 은평구 연신내역_3,은평구,불광2동,33774,112,106,15020,18754,25052,8723,59,53,20,86
2019년1분기,발달상권,서울 강북구 수유역_1,강북구,번1동,320384,795,1690,156241,164144,229050,91337,394,401,796,894
2019년2분기,발달상권,서울 강북구 수유역_1,강북구,번1동,375389,795,870,180906,194482,265619,109770,394,401,443,427
2019년1분기,발달상권,서울 강북구 수유역_2,강북구,수유3동,1967044,2128,3287,978711,988330,1387021,580022,1050,1078,1703,1584
2019년2분기,발달상권,서울 강북구 수유역_2,강북구,수유3동,2244388,2128,2296,1094650,1149741,1563681,680706,1050,1078,1126,1170
2019년1분기,전통시장,서울약령시장,동대문구,제기동,417334,2074,1874,226485,190849,316393,100936,1106,968,1146,728
2019년2분기,전통시장,서울약령시장,동대문구,제기동,500054,2074,1213,268576,231474,380266,119790,1106,968,668,545
2019년1분기,전통시장,청량리농수산물시장,동대문구,제기동,29768,177,15,16481,13287,20662,9106,86,91,12,3
2019년2분기,전통시장,청량리농수산물시장,동대문구,제기동,38486,177,15,21765,16721,26983,11504,86,91,12,3
2019년1분기,전통시장,청량리전통시장,동대문구,제기동,52101,167,20,28266,23835,36776,15326,130,37,12,8
2019년2분기,전통시장,청량리전통시장,동대문구,제기동,59260,167,9,33894,25365,42885,16374,130,37,7,2
2019년1분기,전통시장,청량리종합시장,동대문구,제기동,6665,96,69,2736,3928,5405,1260,53,43,47,22
2019년2분기,전통시장,청량리종합시장,동대문구,제기동,17669,96,18,8582,9088,14166,3504,53,43,11,7
2019년1분기,전통시장,신응암시장,은평구,응암2동,44875,210,35,22069,22807,31495,13380,108,102,18,17
2019년2분기,전통시장,신응암시장,은평구,응암2동,43442,210,18,22113,21330,30256,13185,108,102,12,6
2019년1분기,전통시장,대림골목시장,은평구,응암3동,85236,606,333,42712,42524,57744,27496,300,306,83,250
2019년2분기,전통시장,대림골목시장,은평구,응암3동,115777,606,234,56071,59705,78517,37265,300,306,46,188
2019년1분기,전통시장,증산종합시장,은평구,증산동,5078,164,92,2555,2523,3577,1501,72,92,27,65
2019년2분기,전통시장,증산종합시장,은평구,증산동,6316,164,65,3365,2951,4379,1937,72,92,12,53
2019년1분기,전통시장,수일시장,은평구,수색동,10135,114,17,6877,3259,7564,2571,53,61,5,12
2019년2분기,전통시장,수일시장,은평구,수색동,13989,114,9,8762,5226,10434,3555,53,61,4,5
2019년1분기,발달상권,서대문구 서대문역_2,서대문구,충현동,951202,878,3320,509109,442094,779062,172143,434,444,2079,1241
2019년2분기,발달상권,서대문구 서대문역_2,서대문구,충현동,994620,878,1313,538498,456121,816616,178007,434,444,917,396
2019년1분기,발달상권,서울 중구 신당역_2,중구,신당동,721209,286,3935,399383,321827,596939,124269,143,143,1888,2047
2019년2분기,발달상권,서울 중구 신당역_2,중구,신당동,882923,286,764,494294,388630,729182,153740,143,143,425,339
2019년1분기,발달상권,서울 중구 을지로3가역_2,중구,을지로동,501257,487,24690,319447,181809,419663,81595,305,182,15687,9003
2019년2분기,발달상권,서울 중구 을지로3가역_2,중구,을지로동,689333,487,3297,421947,267388,560408,128932,305,182,2165,1132
2019년1분기,발달상권,등나무근린공원 주변,노원구,중계2.3동,22779,191,277,11538,11240,16331,6450,81,110,110,167
2019년2분기,발달상권,등나무근린공원 주변,노원구,중계2.3동,26312,191,73,13059,13252,18533,7778,81,110,24,49
2019년1분기,발달상권,서울 강북구 수유역_3,강북구,수유3동,215107,730,250,109172,105937,153382,61724,427,303,112,138
2019년2분기,발달상권,서울 강북구 수유역_3,강북구,수유3동,252008,730,97,126397,125611,178811,73198,427,303,49,48
2019년1분기,발달상권,창동역,도봉구,창4동,843464,627,1964,468748,374713,596215,247245,377,250,1023,941
2019년2분기,발달상권,창동역,도봉구,창4동,1038938,627,1106,563118,475820,718508,320429,377,250,645,461
2019년2분기,전통시장,푸른터시장,금천구,독산3동,22376,43,4,11215,11161,15700,6674,24,19,2,2
